kirain cuma di saya tapi tetap pakai soal worth it	positive
di by u mbps bisa kalo yakan bikin paket	neutral
ujung ujung cust yang rugi padahal beli kuota topping kan biar kuota utama ngga sedot	negative
blm pernah cb by u sih jadi tidak tau gimna	neutral
jaring kenapa hilang tiba tiba nih berat kali beban hidup ya	negative
serius nih tiap bulan sekaali min	neutral
nungguin thr dari by u aja kak tcoxocomvqv	neutral
saya gadapet kuota anniversary tahun	neutral
nyaman aja sih	positive
g tidak masalah sih	neutral
g nya byu dah cukup buat drakoran	positive
saya sudah guna by u tapi lupa nomernya gimana cara cek nomor	neutral
gb lebih sih kadang	neutral
penting banget sinyal by u yang skrg jadi lot nih dikawatirkan menganggu mental health	negative
min isi pulsa byu bisa lewat tokopedia ga sihh	negative
tolong dong ini byu lg ganggu atau apadah tidak biasa begini ini lot banget mau apa ig twiter tidak mu tcouwcrwkt	negative
ganti yuk ke	positive
beli pakai linkaja sukses saldo sudah potong riwayat juga sudah sukses	positive
min yg cap satu jempol gb mana kok tidak ada	neutral
bisa beli pulsa by u	positive
signal full sayang g sering rto dan speed internet jelek banget tcolcvsydbpgd	negative
sinyal ini gimna parah gin jaring admin	negative
jaring internet nya baik	negative
masa buka aplikasi by u juga ga bisa	negative
bagus itu lama saya pakai belum pernah sekalipun dapet sms nyasar pinjam online atau dapet kejut had tcokyharcjoou	positive
by u bikin paket yang masa aktif unlimited dong buat perangkat iot gitu	neutral
kak kenapa ya by u tidak ada koneksi internet padahal sinyal full dan kuota unlimited masih panjang tconbfndouoo	negative
masih gabisa internetan sudah hari	negative
bang masa buka spotify aja harus pakai vpn	negative
min kok dah dari hari yang lalu aplikasi nya ga bisa buka terus ku kira gara blm ku update	negative
liat league code fantasynya mana ya	neutral
	
admin by u kamu nctzen kah	neutral
buruk amat nih sinyal beberapa hari ini	negative
lanjur gb gabisa buat stream telegrm provider broken	negative
hehh jaringamu hari belakang ini bikin ganggu mental lho	negative
tiap di mention isi keluh	negative
topping mola tv milih yg mana ya kak	neutral
pura pura signal ilang saat gilir jawab kuis	negative
halo saya di bogor kenapa silang mulu jaring by u yaaa	negative
ora usah jawab cak	neutral
parah banget	negative
kalo misal by u tidak baik pindah aja fran	negative
siap sii tapi hpnya yg tidak siap	neutral
masuk aja nih buat by u saya ganti kartu tapi kenapa gitu ya tidak ada kaya showroomnkaya grapari yg bisa g tcoowdidizrwv	neutral
aplikasi kenapa ga bisa buka min sudah minggu loh	negative
please buat promo paket lebih murah lagi donggg masa kalah murah dari si operator kuning	negative
kenapa saya tidak bisa login	negative
gmna ga cintaa ama by u tiap bln beli yg ini	positive
pas banget lte nya bikin stress gimana mau g	negative
baik dulu jaring lu	negative
kaka gua beliin pulsa ko ga masuk sih	negative
bulan biasa habis gb an min	neutral
oooo takiro by u ku tok sing ganggu	negative
sudah bisa dari lama kalo pakai wifi my republic	neutral
tolong perbaikin layan dong	negative
ping waktu maen game minn	negative
akhir akhir ini paket unlimited rb mpbs sering nut nutan	negative
cuma d jam itu kan ka abis itu normal lagi kan	negative
minnnn masa aplikasi byu ku dari kemarin gabisa buka kenapa yaa paket ada	negative
jaring by u lagi kenapa sih	negative
sedih yaaa sampai kapan nih	negative
bebas banget	positive
yang mbps emang ada tapi promo sekitar minggu mungkin dan harga k waktu itu yang mbps k	positive
min knp ya jaring tiba ilang sudah diairplane ttp ga ada jaring	negative
t tapi gua bisa tethering kok	positive
mau tanya dong misal kalau paket unlimited saya belum jatuh tempo apakah bisa panjang	neutral
ini saya tidak bisa konek ke vpn kantor pakai jaring by u kenapa ya sedang pakai jaring lain bisa tcosabboklbf	negative
gimana sih ini buka aplikasinyanya aja loading terus tcoyzwqhusr	negative
cek dm plsa blm masuk	negative
applikasi by u gabisa akses atau emang providerku yg masalah	negative
jaringanya knp dari semalem ga bs buat apa ni	negative
kapan min buat bikin paket true unlimited buat streaming k p hdr	neutral
sudah minggu lebih aku juga tidak bisa buka spotify	negative
dari kemarin kemarin tidak bisa masuk aplikasi gimana neeh mau cek pulsa padahal internet lancar tcohixquwqr	negative
min aplikasi nya gk bisa di buka ya ini	negative
mngkn karna by u tuh kan kalau beli sim cardnya dia lgsg dianterin ke kita	neutral
sama buat game lag ping tidak stabil	negative
by u bgst saya lagi presentasi buat uas sinyal lu jelek banget sumpah tanggung jawab loo saya relain bedagang maleman malah begini ajg	negative
ada apa dengan aplikasi dari kmrn tidak bisa lho buka ipar ku mau aktifin kartu baru juga aplikasin tcozmipxded	negative
kak mau tanya kalau paket habis jyedot pulsa yang ada tidak	negative
sinyal sekarang sudah tidak kaya dulu	negative
min nomor kok ndak bisa digunain yha	negative
untuk konek toped via wifi kok sering error ya min tcopllqnj	negative
kontol biasa lag malam malam	negative
topping khusus nextflix tidak ada ya min	neutral
selamat malam saya ingin aktivasi tapi saat selesai masuk nik dan kk selalu gagal mohon cerah nya	negative
sudah tahun lebih dong	positive
knp ya suka susah banget tiap buka app lama loadingnya keburu ludes kuota	negative
beli pulsa kok ga masuk ya tconkaajfry	negative
kak please kenapa sinyal nya jelek banget tcotuywdpeew	negative
tidak niat apa buat paket malam itu doang kurang di byu kuota malam hehehe	negative
gim cara aktifasi kartu perdana byu sudah coba hubung jual tapi tidak ada balas	negative
sedih bngt ga bisa di panjang masa aktif kuota	negative
ini tolong ke apa aplikasi by u ga bisa buka yaaa	negative
samaaaa banget problemnyaa	negative
kalo lg ujan skrg sering lot	negative
ada saran cara setting internet	negative
kenapa aplikasi kalian tidak bisa buka	negative
masih lot	negative
min knp akhir ini sering hilang sinyal sampai no service jam lebih	negative
boros banget	negative
mau nanya min yg euro fantasy dari by u reward permatch day itu beneran min tcofwnhelvgc	neutral
by u kenapa gabisa login dah why	negative
eh sumpah benar bangettt dari bulan kemaren tidak si lola banget mana ngezoom ngelag mulu	negative
ini knp kok transaksi pulsa batall	negative
byu sekarang sinyal lagi susah banget ya min mengsedih	negative
min kenapa koneksi dari kemaren ga bisa buat buka netflix ya	negative
kok topping ga bisa dipake ya apa harus ada paket utama	negative
seru kalo sinyal stabil	neutral
cuma sayang makin kesini makin asoy sinyal buat buka apl bayu aja ueng ueng mulu kaya obat nyamuk	negative
saya isi pulsa tanggal kemarin sampai sekarang blm masuk	negative
kalo mau pakai kuota pak kak dia nyediain unlimited hari cuma k	positive
parah emang	negative
simcard bakal ganti tidak nin sama paket bakal ngikutin kuota yang lama atau ada kuota khusus g nanti	neutral
ken p soal ada kuota tapi nyata speednya ngikut yang mbps tidak bisa lancar kalo dinaikin	negative
min jika beli toping whatsapp	neutral
gmma ini masih gabisa login	negative
min knpa byu sya tidak bsa buka ya padahal brusan update	negative
aplikasi lagi error ya nin	negative
aplikasi u noh benerin dari kemaren eror mulu heran tcofrnsofwzzw tcotzpepeh	negative
min diri mau nanya kalau pakai paket yg unlimited	neutral
ama knp barusan tbtb ghosting lg klimaks streaming anime padahal	negative
dapat kado kuota dari nindy wkkakakakka makas nindy tcoxjmkpotnwi	positive
min kagett liat notif huhuu makaciiiii lumayan bisa buat streaming hello future nya dreamies besok tcoowbckmsoiw	positive
min ini sinyal benerin dong	negative
sumpah ya emosi banget sudah sinyal kadang harus di airplane mode dulu baru normal sekarang aplika tcorqyado	negative
knpa aplikasi di bukan forclose trus nyebelin sumph	negative
hari ini maintenance sampai kapan mau beli kuota barusan malah maintenance	negative
tau kalau sinyal by u paling stabil	positive
min aplikasi by u dari kemarin eror terus padahal mau beli paket ini gimana sudah clear cache install ulang tapi tetep aja ga bisa error terus	negative
waa samaa ampe uninstall install lagi buat mastiin	negative
ni gaada acara apa kan min mau isi pulsa kok gbisa	negative
mbps donk	neutral
by u kenapa app nya gabisa dibukaaa mo beli paketann wehhhh	negative
halo kasih jelas dong kenapa tidak bisa buka netflix	negative
ngelawak apa gimana dah kata mb s lah malah download aja stuck di kb s ibarat beli sandwich tapi c tcoixaisvlui	negative
begini terus nih tolong laaaah tcombviphdgr	negative
min gimana ni mau cek kuota jadi tidak bisa ni	negative
halah min jadi salah tcomnvtusxu	negative
min kenapa gin terus mau beli paket yaampon tcorvfvbyasw	negative
di saat ga mati lampu hujan soal sinyal ilang kaya gebetan	negative
dari dulu pakai keluh gin terus paling susaaahh buat buka aplikasi itu padahal kuota jelas jelas tcokkyrfd	negative
saya tidak bisa aktif kartu saya karena staff byu libur sabtu minggu ini provider jasa atau pns ya tcohdcujcze	negative
harga mahal kuota boros pasti	negative
min kenapa by u saya sinyal jelek kalu dimainin pubg	negative
nindy lagi ganggu kah mau beli paket kaya gin ke logout gabisa login tcoxfkqluimhc	negative
fix kalo masih gk benar internetnya	negative
kenapa emang di aku normal kok hud keane u belum update deh kalo belum update emang stuck gitu di logo gamau masuk	positive
signal km hri ini lg kenapa lot bngt sy mo nongton yutub	negative
sila coba akses aplikasi byu pakai koneksi internet provider lain ya kak	negative
paket unlimited yg ribu hilang mana min	neutral
kenapa ya by u aku gabisa buat buka instagram huhuhu	negative
km lgsg dm kendala aja nanti bakal bantu	neutral
halo kenapa ya kalau pas pakai by u ga bisa buka twitter tokopedia amp	negative
kok ga bisa aktivasii	negative
jaring dibenerin dulu min sering reconnect pas kulon nih hadeh sekali connect putus putus	negative
tambahin bts nya biar nyampe pelosok desa	neutral
kapan ya ada cowo bulshit yang ngucapin met tahun sampai maut pisah selain dari tcogtpgocbs	positive
jaring internet nya jelek banget itu juga gara gara nya mati listrik	negative
ganti hp lagi dong ke g	neutral
gb rb hari	neutral
kok tidak bisa buka aplikasi mau beli paket nih urgent	negative
sudah lanjur kecewa mas	negative
cepat baik mau duit tidak ak mau topup kuota ni	negative
dear kenapa beli kouta aku gagal opps beli merchants tidak hasil eh tapi lihat saldo link aja tcozamgjfih	negative
bayu kenapa skrg buat norren ampas banget mentok kbps tcoobukajprs	negative
by u lama lama ga worthy baru tgl kemaren isi gb ehhh lah kok ini dah habis padahal ga dipake buat yg boros tcoqvbapdlw	negative
btw kok koneksimya makin makin yah bantuin dong	negative
sumpah sinyal lu makin kesini makin gajelas	negative
aplikasi error nihh ga bisa buka payahhh	negative
sudah sampai lokasi pick up tapi kartu tidak sedia busuk tcovoykkwkc	negative
emg cacat ajm by u apalagi buat main game	negative
	
ganti ka kartu mentari	negative
sinyal byu nya harus stabil sih min	negative
ada min kuota habis pas tgl tua	neutral
byu ikut telkomsel juga	positive
mgkn ya di atas atau	neutral
min kenapa aplikasi byu susah buka	negative
min saya dari siang mau aktivasi kartu by u gagal terus	negative
ini hilang sinyal nya rutin ya lg dibutuhin ilang anjir kesel saya tolong jawab dong	negative
belum nyobaa sih min belakang ini main game ping tidak stabil	negative
abis gaji pindah haluan langsung	negative
eh ini jadi gmn bro ane baru ngalamin barusan buka web steam market aja ga bisa	negative
beneran tidak	neutral
sama punya aku juga tidak bisa buka gimana ya	negative
lempar lembing	negative
aplikasi gin knp tcovzwwuobk	negative
kemarin dari pagi internet tidak jalan sudah coba restart kali kali tetep aja gabisa	negative
halo min tolong adain kuota topping buat baca lezhin	neutral
kak kalo sim card hilang bagaimana cara biar dpt yg baru ya	neutral
di bogor ampas banget jaring ya ngab para si ping ga stabil naek tinggi haha	negative
koneksi internet saya bagus loh kak ini ajh sudah buka yg dua kali krna yg dulu ga bisa vidcall skrg juga nih sudah bbrpa kali nlp tapi gabisa tuh baru beli kuota juga di tcopkyhvbnn	negative
ga perlu kak makasih saya selalu pakai unlimited lancar jaya kok	positive
butuh mbps rb nih atau mbps rb oke lah atau mbps rb oke laah	neutral
harus hari hikdd	neutral
emang najis banget anjir	negative
gadapet thr	negative
benar bangettt kalo saya si karna pas ada thr yang itu mas ada jadi sayang aja mau beli yang baru	positive
nindy pke kartu tri dulu pas main pubg	negative
sudah update	neutral
gasabar ngrasain g nya byu dengan cepat mbps	negative
kenapa sinyal jelek sekali	negative
ini kenapaa yaa mas belum bisa buka aplikasinyaaaa besok sudah abis nih kouta w	negative
kok ga bisa buka netflix sih anjirr	negative
beuhh dicuekin uy koneksi g nya ilang nihh di tanjung duren jakbar check knp	negative
bapuk banget kl lg ujan	negative
samaa ini mau ngisi gabisa bisa	negative
bapuk kali tcospxivzskf	negative
kenapa sekarang sinyal by u agak lelet ya	negative
wkwk iya gan di daerah bekas utama di bekas utara parah banget sinyal	negative
aku juga masih forceclose mulu nah	negative
kesel banget template mulu yg keluar tcochnizxzlm	negative
cs baik lama ini adalah	positive
masa buka aplikasi aja susah banget ga bisa bisa	negative
min gin terus kenapa ya mau beli kuota susah minta ampun tcocqakhpx	negative
g di palembang kapan min	neutral
kenapa gin terus	negative
minnn kalau kartu byu ilang bisa sen kartu baru pakai nomor yang lama tidak	neutral
aku tanya lewat dm tolong balas	negative
tolong dong speed nya sesuai dengan paket mbps sedih liat nya kalau gin tcohdyhriyj	negative
waduh buka youtube p putus ya min	negative
koneksi stabil dan ping hijau adalah kunci	negative
kuota mbps itu emg signal nya h aja y min tidak g	neutral
ciee anniversary nya sama moga makin banyak promonya ya eheh tcoxuzcpeohrl	positive
halo by u saya mau ambil kartu di indomaret kok tidak keluar ya nomor invoicenya	negative
ada masalah apasih aku buka aplikasi buat beli kuota tapi ga bisa mulu ngide buka di web pc malah gin trs trs kemarin aku chat admin sampai kirim email juga ga ada ubah tcozartvtnhx	negative
saya sudah selalu beli di abang konter	neutral
gimana cara kang ini payah	negative
tidak usah saya pakai data seluler aja daripada nanti emosi saya puncak tunggu respon kalian	negative
ini knp jdi ke log out min tcoypvclgn	negative
bro eror kah kenapa tidak ngebaca sinyal internet dar tadi	negative
lagi ngapain pakai kartu seleb	neutral
boro updatean	negative
kenapa sih kalo ngasi kuota gratis gapernah bisa dipake	negative
appnya kok makin susah buka sih tcobwzskw	negative
eh knp by u ga bisa buat masuk zoom sumpah bikin panik aja ini provider	negative
min maaf mau tanya beli pulsa by u tidak bisa langsung ya tidak pakai aplikasi	negative
murah sih	positive
saat lg butuh tiba ngilang semua	negative
tidak ada paket early bird kaya telkomsel	neutral
jatah speednya berapa ini min	negative
kok ada byu nyasarr	neutral
saya mau buka apk kenapa daritadi gabisa bisa si anjir lo mau saya tetep langgan ga bales cepet	negative
dua jempol paling mantap buat jatah bulan emg	positive
bisa stabilin sinyal tidak ehm	negative
aaa byu gemes banget makasiii	positive
mau regitrasi by u no ke nyata tolak karena kata sudah ada no telkomsel pas dicheck ke galler tcothqoplbm	negative
saya punya speedy dan telkomsel sama lot suruh bubar aja	negative
beli k biar hari malah kuota tunda huft beli k cuma jam tcokizifrmj	negative
pnting banget g sih buat seseorg yg emng gampang down saya mlh mikirin orang bkan gwnya	negative
kenapa saya tidak bisa instal aplikasi by u kak padahal internal sy masih oke	negative
kouta saya yang belum masuk gimana nih	negative
apk lo aja susah buka	negative
aku baru aja ini kenapa plis panik kirain masa aktif habis apa gimana	negative
iya nih di aku lelet banget kuota masih gb juga	negative
	
siap tapi hpnya bom support g	neutral
dah mayan	positive
emang jaring paling ngaco	negative
gagal kirim terus kenapa ya kak by u tcoafwlfymfk	negative
sinyal yang benar aja nih dari siang orang lagi deadline woe	negative
kak gmn uda di respon g sm mereka	negative
makasihh yaa	neutral
gimana nih yg di ios sudah beberapa hari force close mulu	negative
kak coba cek jaring saya tiba tiba hilang	negative
sudah g	neutral
biasa gb ke atas min	neutral
min polsa byu bisa transfer ke telkomsel ga sih kalo bisa gmna cara	neutral
aku capek sama kamu	negative
hampir gb	negative
min tolong ini aplikasi kenapa tidak bisa buka yaa	negative
min ini gimana lot banget sini	negative
cman aku aja apa yg lain juga rupa ini gmna dah min lot banget tcorwqglkpqe	negative
hauuu tidak g nan dulu tiba tiba sinyal telkomsel ilang tempat aku padahal towernya dekat	negative
malam sy beli paket gb hari namun hasil speednya kecewa sekali	negative
cara nukerin u coin jdi kuota gimana	neutral
halo admin kenapa app b yu saya tidak bisa di buka	negative
bapayupu sipinyapal kapamupu jepelepek bapangepet	negative
kalau mau yg unlimited bisa pakai ini	neutral
asli enak banget lebaran dapet kuota anniversary dari by u huhuu makasih min	positive
miiiin kenapa appnya error yah gabisa buka teruss sudah hari tolongg aku gabisa beli paket	negative
darah babeh lu warna ijo sinyal gua ilang nih bangke	negative
goblok	negative
hallo admin sinyal by u kok jelek amat buat maen game ml	negative
paket byu yang jelek luar biasa otomatis beli kuota pakai provider lain	negative
masa tiap menit harus matiin data biar sinyal bagus goblog banget	negative
jaring nya benar benar bikin emosi	negative
kendala via dm agar privasi jaga makasih ghia	neutral
minggu lalu paketin masih mb skrg balik mb biasa banget slalu tinggal	negative
ini paket yang satu jam mana ya	neutral
isi pulsa dari tokped kaga soal logo di tokped kartu as	negative
hari hari jentet tcosvrcbqnlt	positive
ngapa nihhh min mau paket ga isa meleeeeee tcoiojkwrhca	negative
min kenapa isi pulsa gakbisa ngecek kuota pun gakbisa	negative
k gb huhuhu tapi kangen yg gb hari itu yg dulu	neutral
halah keluh jaring jelek agak gubris	negative
by u sinyal sangat sangat sangat buruk bulan akhir	negative
ganti aja ganti daripada ngebatin	negative
bukan cuman jakarta ini di sukabumi paket data masih gb cepat download gk sampai mb s	negative
wah parah tulang punggung komedi tidak di mention lol	neutral
byu kenapasih koneksi tumben banget ancur gin dari kmrn	negative
user yg tiap hari komplain namun tak gubris pasti tertawa baca tanya ini	negative
jaring kenapa lagi nih dari sore tidak beres	negative
asik loh pakai	positive
apa jaring super safe n sound jngan dihilangin	neutral
hari gin jangan temenan sama jaring internet yg lelet dan lot pakai kuota hemat dari telkomsel by u yg super tcoxtstuuyuq	positive
kenapa aplikasi byu saya gabisa di buka ya sudah clear data	negative
min kalau nomor byu bisa pakai di malaysia ga buat terima otp terus topup dari malaysia online tetap bisa kan makasih	neutral
cara unregister no by u saya bagaimana	neutral
cie sudah anniv ajanih kita tcoawjgtkyja	positive
min aplikasi error gabisa login	negative
aslina kamar di mangunreja signal ngaleuleup	negative
min kenaa internetnya macet ya paket semua mau	negative
min nanti kalau telkomsel masuk g	neutral
ini ke log out dari app dan gabisa log in ngapa dah	negative
sudah bisa beli by u yang bulan ribu	neutral
makasih by u asik banget nih dapat kado tcounzqwccxa	positive
mau lu apa si udh mau jam lo gada sinyal ye kocak najissss	negative
saat ini aplikasi by u di hp ku tidak dapat akses sehingga sudah lebih dua bulan tidak dapat beli pakai tcodeophpa	negative
nyaman nomor min	neutral
beb kmu kenapa beb dari siang koq down terus data internet putus g ga nyangkut	negative
eh ini paket apa anjir hahahaha sumpah gua harus belu	negative
kenapa by u gabisa buka netflix tanpa vpn dari kemarin susah banget mau nonton netflix	negative
murah tapi merah lelet	negative
nah gituuuuuuu	neutral
kenapaaaa no serviceee sihhh tcoseeshcqq	negative
apn nya apa saya pakai bawa kacau benar ping nya	negative
min coba kmu ganti akun dulu min biar ga bikin gempar	neutral
bebas main game tanpa jump ping hehehe	positive
mau lihat sisa kuota ga bisa terus	negative
ga ngitung mba aku pakai internet unlimited dari	positive
halo min ini kenapa dari kemaren muter terus ya	negative
ini gimana siii ga bisa log in tcoppjestmw	negative
bilamana sim card rusak	neutral
rumah suatu ruang yang ada kasur dan colok panjang dengan sinyal yang kencang min	neutral
iya g aja belum benar	negative
min kok by u untuk zoom ga bisa padahal kuota masih gb	negative
jarigan nya jadi jelek knpa yaa	negative
curang banget sih	negative
yg k min	neutral
knpa jadi buruk gin dahh mana kuota topping tiktok kaga potong njirr mayan bngt k sia nangisss	negative
ping lu jelek banget	negative
jaring full	positive
ganti hpnya yg mahal min	neutral
paket unlimtd yang mbps bulan sudah tidak ada ya	neutral
harus rekor ganggu aplikasi dong biar kita lebih relate	negative
halo min tolong ini banyak spam makan pulsa mulu tcomyvivqru	negative
jaring not connected sejak pagi	negative
hai min ini by u di rumah saya kok sinyal cuman g ya aku mau ada kerja jadi ganggu nih	negative
gamenya tambahin dong dari supercell kayak brawlstars atau clash royale	neutral
tapi aku pakai juga dan aneh lancar tidak tau ini kok beda sendiri	negative
makin mahal apa makin murah	neutral
bayar pakai shopeepay	neutral
tolong jangan minta saya kirim dm ya	negative
solusi adalah thetering ke tmn yang pakai operator lain	neutral
dear tolong sinyal baik di sunter tiap hari memble	negative
hahh haru aku tu makin sayang terima kasih tcodlwlcuegl	positive
maksih kado tcojzyycdo	positive
payaahhh kagak bisa diandelin sinyal lot parah konsumen kabir inimah	negative
aplikasiny error sejak kemarin mau beli paket atau cek kuota gk bisa di slain aplikasi	negative
kaget dund dapet notif nyata dari kasih kabar bahwa sudah tahun jadi lupa kapan pakai by u tam tcoexxancqjoq	positive
yang tercover wilayah crazy rich jakarta semuah	negative
byu sehat jaring ngadat mulu lelet kaya sifut	negative
kok aku ga pernah dapet happy anniversary	neutral
tempat g aja ngos ngosan min	negative
min ini ga lupa switch account	neutral
toping whatsapp bulan rp	neutral
jaring dikuatin	negative
sudah bisa gila gara tidak bisa buka aps by u	negative
dah abis ini ganti provider blacklist sinyal ilangan terus gajelas	negative
kalo sampai ini paket hilang	neutral
kenapa mau buka apps pakai jaring sendiri selalu something went wrong	negative
tidak bisa akses spotify sudah biasaaa tcokwyjnu	negative
udh app error	negative
aplikasi saya tidak bisa buka info nomor telfon dan email sudah saya kirim di dm tolong di cek	negative
pakai by u	neutral
kok aplikasi by u di play store tidak ada ya	negative
mari kita pindah operator lain	negative
sinyal aja kadang suka ilang ilang	negative
jaring nya jelek banget	negative
sulit banget buat komplain	negative
kok punya msh bisa ya	positive
masih nunggu esim nya by u	neutral
jaring internetnya busuk woy elah	negative
endingnya kurang greget	negative
kak rb mbps cepat sama kaya kuota biasa tidak	neutral
tidak stabil banget sih di cirebon	negative
pakai by u sambil nonton tns di yutub eh lagi promo by u trus tau akun by u nya post juga sungguh betul tcofzktyicm	neutral
aplikasi saya tidak bisa buka info nomor telfon dan email sudah saya kirim di dm tolong di cek	negative
min pasti kamu gabut y	neutral
besok bisa nonton hibur gratis	positive
harap kosong	negative
kenapa ya saya tidak bisa buka aplikasi nya saya mau beli paket data soal tcoojfqurzdy	negative
makin hari makin lelet	negative
kenapa pas di connect ga bisa internetan	negative
keren banget kartu ilang ganti dikirimin yang baruuu aaaa ga perlu ribet ksana kesini mantaff tconftgmjgq	positive
twitter ig yutub wa dah gt ja teroooos	neutral
nindy ini kenpa dri pagi gin mulu ya paket mo abis ini tcowqycywmh	negative
halo by u maaf nih mau tanya kenapa sekarang ga bisa play spotify ya sedang pakai operator lain lancar tcolszlicad	negative
halo kenapa kalo buka app netflix spotify dan bahkan apo by u sendiri tidak pernah bisa ya	negative
sedang ada ganggu	negative
kakak aku cuman mau bilang makasih karena sudah ngirim kuota di hari ulang tahun aku	positive
lemah ya donlod game lah eh tapi ping nya puayah sih	negative
gantung nindy ngasih gratisanya berapa	neutral
nct muk koleb sama by u ya min	neutral
kenapa sinyal ga mau g dari tadi siang	negative
by u g kapan min	neutral
help min mau cek sisa data jadi ga bisa	neutral
tolong baik server nya lot banget	negative
sudah min aq pakai dari desember ucoinnya tapi baru dikit min benerin dong aplikasi sekarang sering banget something wrong aq pakai unlimited tapi gbisa buka spotify dan pinterest	negative
indosat dong	negative
min saya habis transaksi untuk beli kuota	negative
bbrp bulan ini lg kacau banget ini si by u harus sering restart device biar bisa konek lg ke w tcoxupotlblr	negative
kalau sudah g paket unlimitednya nanti tetep max mbps min percuma dong	negative
nyari yang ada wifi nya dong	neutral
tapi tetep aja ya lelet sama konek ke server host apa makin lelet tapi noren parah sih film gb biasa jam ini hari nonstop baru beres	negative
kenapa sudah hari ini lot banget	negative
ping game bisa lebih stabil lagi	neutral
sebelllll	negative
aplikasi updatean akhir kok force close terus ya gimana saya mau paketin data kalo gin	negative
	
pernah baca di web cerita itu karna ga di sebutin hotel apa pas cek in temen ngechat nanya mana aku jwb di hotel trs dia jawab sumpah ga takut	neutral
eek sinyal kenapa ndak ada sinyal balas cepat	negative
min ngak gb aja min tcodasqffe	neutral
brisik ajg	negative
min mumpung masih sayang sama byu tpi nahan emosi komplen dong knp dipake yutuban lancar	negative
tingkat dong jangan mbps terus	negative
masih pakai kuota yang hari unlimited	neutral
ini kenapa aplikasi dari kemaren something went wrong terus yaa	negative
kalau ngk pakai vpn langsung ada notif error tcojllmtvqr	negative
ganti provider grgr lagh mlu woy asuuu la	negative
minnn kemarin aku ultah dapet kuota gratisss senenng abizzzz sudah tahun pakai	positive
g by u aja pakai main game sinyal ngelag nih	negative
blm juga genap bulan sudah gin	negative
malah suruh pakai hp lain dulu	negative
ka besok tambahin genshin impact yaa	neutral
padahal bulan lalu lancar aja buat buka apa	negative
hallo min ini knapa ga bisa login pakai semua metode yg ada yaa mau cek amp	negative
yang penting abis upgrade jangan eror lg aja	negative
min ini aplikasi kenaap ga bisa login mau beli paket kurma juga	negative
min adain kuota khusus sahur dong biar ga tekor	neutral
mau tanya ini bayu tidak ada topping untuk sms ya terus kalau k tcolmuecp	neutral
ini kenapa main game malah disconnect terus	negative
gpp nyata add paket mbps sip nindy	positive
punten kang kenape ini gin ari masih g aje tcopdmvxnxa	negative
admin nanya dong kok aplilasi by u sering banget ngga bisa akses ya tolong dong segera baik susah bngt buat ngapa ngapain kalau aplikasi masalah soal	negative
min ini kenapa ya byu jaring tidak bisa dipake sama sekali dari tadi cuma g doang	negative
makasiiiiiih happy tahun bersamaaaa tconmppxdzo	positive
tri lah ajg gewla lohhh	negative
ini loading mulu appsny kak	negative
pay pay ngomel mulu saya liat nih sudah ngomelin mola sekarang telkomsel	negative
makin hari sinyal makin huh alah	negative
lagi ganggu jaring apa gimana	negative
benerin dulu jaring woy	negative
cara untuk renti paket unlimited gmna min	neutral
pakai buat muter spotipi doang padahal pakai acara buper putus putus segala smh smh smh smh	negative
aplikasi saya tidak bisa buka info nomor telfon dan email sudah saya kirim di dm tolong di cek	negative
halo kak aplikasi apakah sedang trouble ya kok tiap buka keluar terus padahal belum buka	negative
iyaa sih tapi masa tiap mau play spotify kudu restart hp	negative
byu ini gimana ya cara buat nambah cepat internet nya lama capek juga pakai byu	negative
apakah balikpapan sudah g untuk by u	neutral
haduhh kenapa sih apk nya error mulu	negative
tingkatin dulu kualitas g di semua wilayah	negative
beberapa komentar di sini bikin ngakak karena polos mereka tapi ada yang bikin tuju naikin cepat unlimited nya	neutral
gimana nih dari kemarin ga bisa terus tcowjrgxzolay tcoccqmjqua	negative
pusing yaa mana lgi nugas	negative
mau juga ganti provider tapi yg lain lebih busuk lagi drpd ini yg kata mah sinyal paling oke	negative
miiin apk nya gabisa buka jaring lot	negative
buat streaming netflix atau ga viu yutub juga buat nemenin kerja hahahahah	positive
min tolong cok pen pus rank aj sinyal jemping dri semalem elah	negative
ni si goblok nih ngaku satu provider sama tsel promo kuota banyak pas dipake sinyal ancur ancuran	negative
aku pakai byu hampir th gada bonus juga	neutral
emang murah ya	neutral
kalo ribu rupiah buat tahun baru saya pindah ke by u hahaha rb hari sih yg lain juga bisa kasih ke tcojyompuf	neutral
kalau kasih rate ya	positive
ini kenapa ya kok ga ada signal	negative
by u buat buka quora ga bisa buka foto di twitter jugaa loading nya lamaaa	negative
min kartu by u aku telah d registrasi ko g ada kuota	negative
benar banget kenapa nih sinyal dua hari jelek tbtb ilang tbtb mati data	negative
aplikasi lagi kenapa sih sudah beberapa hari gabisa login something wen t wrong terus ada yang gin juga ngga	negative
anehh sinyal kek tai	negative
sinyal aja ilang ilangan	negative
sinyal nya dulu woiiiiii yang g aja masih lot sudah mau g	negative
tidak tidak sinyal di rumah saya jelek banget padahal awal bagus lancar jaya	negative
kok kaga bisa buka instagram sih	negative
sekarang tweetnya sudah hapus semua kemarin tidak sempet ss	neutral
sudah bisa telah pancing pakai vpn	neutral
paket kutoa gb aja sama ngga bisa akes tokped	negative
hmm buka app aja tulis something went wrong mulu	negative
yg gb habis hari gegara wfh	neutral
thread fantasy euro mana	neutral
bentar lagi aku ultah	neutral
kayak ga balesim mention deh	neutral
by u app kamu kenapa by u kok gk bisa dibukaaa ini aku mau ngisi paket tinggal gb iniii	negative
goblog	negative
sering trouble aja bulan april kemarin gb min tcogyaxkyuvm	negative
tiap bulan min	neutral
tidak semua hp g support jaring g telkomsel	neutral
aplikasi gabisa buka dari kemaren kerja pakai apa ini	negative
malu sumpah kecewa banget tcocnnhwfam	negative
maap jbjb saya juga udh protes ini dari awal bulan kirain cuma saya aja yg ngalamin pas udh di report malah hasil ga ada yang salah kata padahal saya sudah kasih bukti banding dengan jaring tsel juga tolong dong dice	negative
sinyal busuk	negative
cara pindah untuk ambil sim gmn yaa waktu daftaar kata di indomaret ready	neutral
demi allah sinyal jeleeeekkk bgtt	negative
min apkah lagi ada maintenance atau gimana	negative
di by u mbps	neutral
error mulu makin sini makin ancur nih nama juga awal doang yang bagus pindah provider aja yuk	negative
agak kapok pakai masuk mobile legend aja ga bisa sering buka twitter juga ga bisa	negative
kapan nih aplikasi dibetulin	neutral
aplikasi ga bs buka	negative
promo yg ini tuh masa laku sampai kapa yaa tcoidhuzlkhl	neutral
buat wa pending ga saya ngalamain pending hari ini asli	negative
ken bebas kuota internet	neutral
adiminya gabut nih pasti	neutral
kuota habis dari kemarin eh tadi sore sampai sekarang wa twitter masih bisa on	positive
paling parah torrent sih benar kayak kunci speednya	negative
aplikasi knp ga bisa buka ya erorr mulu ga bisa top up tcomoubrxiboy	negative
coba connect wifi yar punya bisa atau km mode airplane sek hbs itu bisa	neutral
karena hari ini umum kelulus jadi notif lebih spesial daripada ucap selamat lulus terimakasihh tcojiwjppf	positive
app by u sampah banget si gimana mau isi pulsa kalau error mulu heleh	negative
sinyal kok makin kesini makin suka ilangan sih	negative
terima kasih by u lama bulan ini ajar bagaimana aku harus sabar di bulan ramadhan ini sampa tcodllbhjtej	negative
min nda bisa paket via dana sudah minggu gin	negative
kok kuota yang gb hari udh ga adaaaa	negative
lumayan asupan nanggung bulan thank you tcoibdtjmure	positive
koneksi benerin	negative
bagus kok	positive
ingat game itu bagi bagi orang adalah bisnis	neutral
mau tanya ini kenapa ya ga bisa terus buka smp hari ini telah update tlg bantu mau beli pakai data tcobmnrrywaf	negative
aku tadi isi pulsa jam bayar lewat shopee terang sukses dan cb koin nya juga sudah masuk tapi pas aku buka aplikasi by u pulsa aku belum masuk gimana min	negative
smaaa sebel banget lamaa	negative
ini gaada pilih metode bayar gimana ya min tcopfiasff	negative
haloo ini aplikasi sampai kapan ya ga bisa di buka gin	negative
error kok terus	negative
mesti lot	negative
paket kurma gb hari saya blm masuk	negative
kok by u aku gapernah dapet ya	negative
rem min kalau paket by u ada yang mbps bulan	neutral
halo min kenapa gabisa buka netflix ya	negative
lahh	neutral
untuk wilayah medan sumut jaring kok lola hari ini ya	negative
lewat dm kadang tidak balas	negative
saya udh sabar ya ngadepin km akhir ini	negative
sudah dari awal daftar kok isi tanggal lahir cm emg gaperna dapet deh	neutral
jaringa u napa flop banget dah bbrp hari akhir ini	negative
main game jaring stabil	negative
chat wa saya tidak ada yang masuk dari sore kenapa ya	negative
keren ini follow up dari customer servicenya	positive
koneksi g dengan sinyal penuh	positive
beliin kak	neutral
min daerah saya ga tercover by u kah	neutral
ga nyamanepool saya sudah report sana sini gada yang follow up	negative
nindy ini gimana kok saya tidak bisa buka aplikasi by u dari kemarin mau ngisi saldo dan paket tidak bisa	negative
halo tolong dong kenapa saya gabisa buka tokped pakai jaring ini padahal pakai jaring lain bisa	negative
min mending buat anniversary tiap hari	neutral
min sinyal sudah tidak g lagi nih gimana ini kasih deh aku	negative
kalo mau komplain kmn ya	neutral
ha a aku kaget dapat tambah kuota dari by u	positive
topping game terus masih banyak udh hangus	neutral
gaes lagi ada promo banjir kouta dari by u gb ribu nih bisa buat internetan lama bulan penuh kuota utuh tanpa bagi bagi jaring lokasi dan aplikasi yuk beli kuota by u sekarang	positive
beli paket mahal rb	negative
min aku tidak bisa beli paket data apa lagi ganggu	negative
bang bayu jual kartu koreaa ga	neutral
mantapp akhir ada yg di atas gb	positive
halo saya beli kuota lewat app by u tidak masuk mohon bantu	negative
mas bayu dan nindi ngeluarin fitur judi bola juga	neutral
definisi lengkap tapi simple adalah definisi yang gambar buat iky yuk download aplikasi by u kamu di app store atau play store dan rasain nikmat jadi anak by u	positive
kok jaring lot banget tidak kaya biasa min huhuhu lagi ada baik kahh	negative
min jaring by u di purwakarta buruk sekali	negative
kalau kartu by u hilang bagaimana ya	neutral
emang byu mah beh best dah	positive
kecewa si pakai kartu ini di daftarin buat aplikasi finance d bank gilir kartu rusak proses ganti kartu tcofngbqj	negative
parah bangat nih sinyal	negative
ini kenapa min sedih paket sudah mau abis mau panjang gimana	neutral
dari hari yang tiap hujan petir selalu turun mulu sinyal dan ga bisa internetan sama sekali selalu pakai tetri tcozyxjpvkx	negative
bantu jawab yaa dl pernah nge dm juga masa aktif terus panjang asal lama bulan itu hari itu tcojnwppbcy	neutral
kirain di hp aku aja nyata semua	negative
becanda mulu jaring bosss	negative
by u apps knapa gbisa d buka ya padahal udh update juga	negative
aw tunggu sinyal baik yaaa	neutral
min daerah solo kota lagi ada masalah kah lot banget min sumpah	negative
ada apa dengan aplikasi by u min mau beli paket data koq ga bs	negative
ini kenapa app by u gabisa buka ya	negative
percuma min kalo sinyal byu tetep lamak mah	negative
tingkatin dlu g baru g	negative
hi saya baru beli kartu perdana dan ga bisa aktivasi di aplikasi	negative
ini by u kenapa ya untuk kota batam daerah batu aji sejak hari sabtu tidak bisa guna internet	negative
koneksi internetnya sudah hari ini lot banget kenapa ya ga bisa dipake sama sekali	negative
ga ada genshin impact	neutral
ini gimana sih sudah hari internetnya gabisa dipake mana beli yg unlimited sayang banget gabisa dipake dan m tcoowfockqpy	negative
saya baru beli kartu by u dari promotor by u kartu kuota gb yang kata sudah daftar namun saat saya taruh dihp sim card tidak daftar jaring solusi bagaimana ya	negative
napa ya tadi buat zoom meeting jaring jelek banget padahal kuota masih gb	negative
buat buka aplikasi error mulu min tidak bisa cek kuota	negative
jaring nya jelek banget	negative
kak ini saya dari beberapa hari lalu gin terus kenapa ya sudah update sampai kali soal malam ini nnt tcojvzqewjhic	negative
kok nomer by u jarang nyantool bantu kuota dari perintah si apa cumann nomerku aja ya huhu	neutral
asli yaaaa ini jaring kacau banget hari iniiiii parahhh	negative
gin amat sinyal parah tcolxsrjcupk	negative
eh makasih lho gratis kuota tcokidcckveeh	positive
by u kenapa tcoshnrpertd	negative
orok ga temenan sama lumba lumba warnet	neutral
sinyal bayu kenapa ya suka tbtb ngilang sendiri padahal belum lancar aja minn	negative
jangan cuma hari doang dong min kuota masih banyak soal	neutral
bg kenapa aplikasi ga bisa di buka yg ada keluar terus kesel tolong la mo beli paket ini uda cair thr ku	negative
donlot torrent sudah beberapa hari ini pakai lot benar dah pfftt ga nyampe kb s anjer	negative
	
min jaring lot gin kenapa	negative
buat buka toped tidak bisa ganggu min tcocfmrqln	negative
bangga banget pakai simcard by u cepat jaring yang saya dapat sangat mengaharukan	positive
mimin aku ada keluh nih	negative
iya sial banget asa baru kemarin kok sudah gabisa dipake tcohmzpsbtn	negative
beli kuota hrus restart dulu maksain mau g ntar sinyal ilang hlo huehuehue	negative
mau login pakai nomor ga kedetek login pakai otp begini terus pesan tolong fix lah tcodbumdie	negative
kesel bgtt padahal pulsa aku ampe rban	negative
min minnn jaring nya kenapa ilang ilangannnnnnn aku lagi asiq vc an lho	negative
kok sering silang begini ya min sim card by u nya tcouufzmhtxgn	negative
aman jaya darimana i mbps tapi speed cuma kbps doang	negative
nonton yutub bs tapi log in spotify gk bs	negative
beli data via shoppepay masalah data tidak masuk sedang dana sudah di potong komplainya ribet	negative
min kok gbsa buka aplikasi by u dari pagi tcobnyeecfttx	negative
maaf aku sudah hijrah k indosat	negative
tambah tidak nuiat dadi provider	negative
aku beli ini baru kepake mb buat main pubg eh abis itu malah gabisa dipake lagi	negative
min ini ngapa sih apl by u gin terus di hp ku	negative
tempat gua udh ga ganggu ndeng	positive
min mo tny knp tiap saya mau cek data kaya gin padahal msh ada paket juga ko	negative
min kok apk nya ga bisa buka ya sampai uninstall install lagi tapi tetep tcomzrsaofkc	negative
sudah tapi kalo pakai sinyal by u lot dan alam agak kurang	negative
by u apaa sih sering ganggu	negative
aku malah nganggo byu	neutral
iya kak by u lama ngeselin	negative
diskon kuota sangat guna untuk hemat saat tidak dapat thr	positive
kuota yg harga ko ilang min	neutral
sabar anda download game pc pakai kuota unlimited by u patut puji	negative
asik bagi bagi kuota ga nih	neutral
eh aku gabisa buka twitter tapi yang lain bisa	negative
tunggu klarifikasi	neutral
pakai bulan pertama lancar bulan ikut nya kok sinyal nyebelin ya boro buat main game buat browsing aja lot sampai bikin saya istighfar kali kali pict ke itu hp abang saya masih satu lurah dia pakai pertama gin	negative
min ini saya beli pulsa di konter tapi pulsa kok ga masuk ya padahal nomer sudah benar transaksi nya berh tcodltoujubcc	negative
koneksi byu bln terkahir koq ga stabil ya	negative
paket banyakin dulu rate atas k sudah bisa dapet gb hari	negative
streaming p truly aman share donk yg pernah lagi pakai tcosqocopoaba	neutral
admin jangan jawab gin lagi ya	neutral
sama di ap saya jug tak ada	negative
udh lama ngga nengok ni kartu hm semenjak make tcocltbdnrswq	negative
tolong punya jga begini punya adekku juga ada masalah apa ya min	negative
tetep tidak bisa kak malah cuma kbps tcoektksiolo	negative
min sinyal byu yg error apa telkomsel yg error nih	negative
ciee yg uda th	positive
jaring harus stabil no kecot kecot	negative
min saya kan beli hp samsung di online shop terus dapat kartu perdana by u	neutral
gede apa kuota by u g recommended buat main game drop sinyal parah banget dar g ke h	negative
ni gmn deh buka aplikasi error mulu tiap hari	negative
game itu dikit aja yang penting bulan	negative
percuma g	neutral
	
sudah update app nya kenapa mas begini ya tcomwyrnzson	negative
mbps dong	neutral
sinyal koq makin kesini makin lot ya	negative
halo ka mo ytanya dong knp sinyal g punya sering ilang ya sudah ganti device pun ttp sama jadi ga bisa vcall si dia kann	negative
jaring blangsak tcoimyaaonmz	negative
mana nich sinyal ilang mulu	negative
iya emng rewel banget hdeeh	negative
youtube an tapi masih pikir pikir durasi dan resolusi kuota expired	neutral
tolong dong jaringanya hari lot banget bang byu	negative
gas ges gas ges aplikasi nya nohh eror	negative
kalo kartu rusak cara ganti gimana mana kuota masih banyak	neutral
bukan saya sendiri nyata yg sinyal jelek sejak hari sabtu kemaren	negative
kagak bisa beli kuota nih bang	negative
jaring iku lhoooo ilangan bin lot	negative
benerin dulu koneksi biar ga busuk percuma bagi gratis kuota kalo yang bayar aja ga bisa dipake	negative
kenapa ya nomer by u ga bisa buat telfon	negative
kenapa si kaya gin uda ganti kartu yg ada ketan ttp gabisa buka gin tolong mau paket unlimited tcooefajuqz	negative
min kartu byu orang tua saya kemarin hpnya cebur masuk air terus kartu byunya error gabisa nerima telfon dan telfon ke luar bisa dikirimin kartu baru lagi dengan nomer yang sama	negative
ehhh ini sinyal kenapaaa	negative
nyata yg sinyal jele ga cuman aku tok	negative
sekarang mending sih sinyal dulu lot sekalee	negative
buat buka toped tidak bisa	negative
kok tiba sinyal data ilang ga bisa buat nelp juga kenapa	negative
aneh banget buat gmeet bisa padahal	negative
tolong deh benerin dulu aplikasi	negative
saya sudah punya kartu by u	neutral
cepat macam apa ini	negative
kasih kado sama hiyaa tcovrncwtf	positive
signal by u brpa hari akhir ini lg knpa dah min hari ini donlot mb aja dri subuh smpe skrg gagal trs tcoqwskqwqg	negative
	
min jaring kenapa dadak lama sih lagi kejer target streaming	negative
aplikasi error	negative
saya liat liat akhir akhir ini sinyal kok h mulu sih jd gbisa buka apa apa padahal sblmnya bagus bagus aja knapa ya	negative
gaada jaring samsek	negative
coba akses pakai koneksi internet provider lain ya kak	neutral
sinyal daerah bandung kota kenceng ga mau coba nihh	neutral
kemarin udh beli yang mbps sekarang malah ngongol yang mbps	negative
saya tidal bisa buka app byu	negative
dari kemaren ga bisa bisa masuk apk tcoikinvxca	negative
kak kenapa ya by u tidak ada koneksi internet padahal sinyal full dan kuota unlimited masih panjang tcolfcvgexn	negative
jaring g tapi meni lambat kieu dinten ayeuna teh hadeuh	negative
gb gantung bnyak drakor sihhh hee	neutral
aplikasi kenapa sii gabisa buka padahal mau isi kuota	negative
wow sinyal cepet banget tcotojyqht	positive
sumpah dari pagi gabisa apa apa dah	negative
ini cara ngatasinnya gimana ya daritadi gin terus	negative
sinyal jelek	negative
min ga ada niat promosi pakai mark dan nct apa tcoobinlms	neutral
kasih topping buat netflix dong nin	neutral
kok jaring saya lot ya min	negative
by u ini daritadi sinyal ilang mulu deh	negative
error mulu makin sini makin ancur nih	negative
lancarrrr kok	positive
byu kalo ujan di sukabumi sama cianjur suka jelek yah	negative
aplikasi gabisa buka kenapaaa	negative
ada yg tau kenapa paket games nya lag banget buat main mobile legend	negative
masih belum bisa buka tcobysepurgq	negative
guys kalau ada keluh noren lelet apa iya tanya alamat detil nomer lain sampai koordinat google maps gin ya tcorbvqibnf	negative
cekk dm boleh kaliii biar makin akrab soal sinyal tbtb kosong nih	negative
min cek kuota cuman bisa lewat aplikasi aja ya	neutral
twrgantung speed internetnya	neutral
min aplikasi byu lgi error kah	negative
segitu ngagebleg gede di tiap desktop pasti ada	neutral
harap di dm kasih kuota gerat sama byu	neutral
min kalau g sudah bisa dipake kartu harus tukar ke yang support g	neutral
baru sadar kalo kasih hadian ultah sama makin sayang tcousukajeh	positive
sama ga jelas emang by u	negative
yang pasti dah subcribe dan like youtube episode panjang sketsa komedi bikin ngakakk tcozvyemkdqk	positive
kontol	negative
makasih sayang aku mah emg setiasi anak happy monthiversary tcolthgyhc	positive
tolong ya aplikasi baik mau masuk aplikasi aja susah banget tcohqfscpvtkt	negative
min btw kenapa makin kesini jaring by u suka lot si	negative
eh promo buat yg unlimited aja deng min	neutral
toping ku ndabisa dipake nihh min	negative
kenapa tidak bisa akses tokopedia	negative
by u sinyal kenapa nie	negative
min balikin kuota yg rb gb hari dong	neutral
sinyal lu dari kemarin kenapa sih	negative
eh ada cashback nya makas bayuuuuu ter luv lah tcohmvordltx	positive
udh paling benar unli apus aja ada yg pakai bisa sampai ratus giga	negative
adalah operator paling ccd panjang sejarah cs cuma bisa via livechat	neutral
saat masih ada top up topping k an di by u	neutral
ada ngalamin hal yg sama tidak pakai provider	negative
hai kak mau nimbrung nihhh sudah ga sekarang aku mulai januari gabisa terus mau langgan pakai by u	negative
min app di ios error nih di buka force close melulu	negative
ini kenapa yak website ama app nya gabisa buka	negative
gb an doang	neutral
airplane mode dulu koneksi by u sekarang emang suka ilangan kadang ga bisa buka ig	negative
	
kenapa tiap buat aplikasi sering gin min sering banget lhoo ini kan sebel tcovnquazthz	negative
aplikasi by u lg ganggu atau gmn si kok beberapa hari ini aku buka sering keluar keluar sendiri	negative
mau komplain ke nindy soal hadiah tcooopytszqau	negative
buka ads manager pakai byu	neutral
min kenapa ini aplikasi by u saya dari kemaren tiap mau buka gabisa terus ya sudah saya uninstal instal u tcopzonqtsu	negative
aplikasi benerin dulu aja daripada nanya nanya	negative
belum butuh g si hp juga masih bisa di pakai buat tahun ke depan sayang bangt yang nya kalo harus upgrade hp	negative
sudah brani nonton live streaming youtubenya kompastv jam nonsto tpi ndak tak tonton	neutral
emosi gila beli paket unlimited byu mau donlot lemott	negative
min aku udh pakai by u loh	positive
janji palsu	negative
kalau saya mah	negative
kenapa sinyal jelek mau nonton netflix jadi tidak bss	negative
haloo byuu ini kenpa sinyal daerah tanjung duren jakbar jelek banget ya	negative
koneksi by u untuk game biasa stabil	negative
force close apk nya	negative
dah ada wifi di rumah pakai mbps btw	neutral
hapeku kadang tulis g malah tapi soal cepat gausah tanya beuuh mantab asa g	negative
aplikasi byu tidak bisa di buka	negative
min kalau kartu hilang ngurusnya gimana ya	neutral
min kenapa apk by u gabisa buka	negative
admin di ios force close terus mau beli paket tidak bisa	negative
haha respon lo gin terus min hdh banget	negative
lot banget si heeyyy	negative
sumpah ini sinyal kaya tai	negative
by u kenapa sih dari tadi mau beli pulsa di aplikasi gabisa	negative
gabisa buat akses zoom ya padahal buat lain lancar	negative
halo min plis bantuin dong apps by u minggu ini gabisa buka terus padahal mau paket kalau gin trus tcoxwdxotuad	negative
itu cara gimana ga paham beneran ini ga ke detect dari nomor udh cabut tetep ga ke detect	negative
sama nih sudah jam lebih arghh	negative
jaring lot yg ga abis abis	negative
unlimited dong min	neutral
min udh hari gabisa buka apk	negative
buat ping yang sering ms tconhelphypg	negative
fyi buat kalian apps byu ga bisa di buka kalo kita pakai jaring wifi ya seperti mifi	negative
min kok nyasar btw kenapa paket data langgan jadi naik huhuhu	negative
tolong dong ko aplikasi ga bisa dibukaa	negative
buka riyawat pesan dari by u saya min	neutral
imam hidup fokus ajar	neutral
ngakak banget admin bayu ngikut komen	neutral
ngapa apl lu kaga bisa buka sihhhh kuota saya dah mau abis ini	negative
kok error begini ya	negative
moga semua sehat dan bahagia	neutral
ini kenapa akhir ini sinyal ilangan sih padahal br beli kuota gb tapi malah lot banget azzzzz	negative
btw tengkyu yaa nindy kado tcocughas	positive
cara dptin byu gimanasih kak	neutral
pantesaaaaaan td disaranin buat uninstall trs install lg juga msh gabisa btw makasih info yaa	negative
kenapa topping game sinyal nya sering ngedrop sampai cakra	negative
kenapa paket line sy gabisa dipake dah	negative
minnn take down aja konten belum netizen serang	neutral
sinyal tidak asik banget si akhir akhir ini	negative
siap buat besok hari rabu nonton eps di tcofsuuryqy	neutral
nge lag app u pagi pagi napa deh	negative
duhh makin sini makin lot ih	negative
admin saya buka app byu pakai jaring byu kok ga bisa ya tapi kalau jaring lain bisa buka appnya	negative
min kenapa nih ya byu lg lot banget akhir ini zzzzzz	negative
salam kenal yaa min kmi udh buka pintu lebar banget buat mimin sok min duduk dulu boleh bg tcorjfyvood	neutral
byu kamu kenapaa sih masa gabisa buka wa aneh banget buka twitter bisa pas pakai hospot baru bisa connect ke wa	negative
nih keluh dengerin napa kak	negative
min mana kuota unlimited jam nyaaa	neutral
min kuota clbk sudah ga ada ya	neutral
kenapa saya klik mbps koin dapat gb koin	negative
gaada kuota utama kah kaya beberapa toping butuh kuota utama juga biar bisa kepake	negative
iya kenapa ya padahal nyambung dia baca tidak ada jaring	negative
aku ken juga dong nindy dapet kado dari mu	neutral
aplikasi dan layan thu dibenarin di dm tanya solusi jawab tele	negative
ken euy kalo kartu baru ada tidak ya paket ini	neutral
lapor pertama ga ada respon	negative
aplikasi lg eror ya tcogqohknbsco	negative
sinyal lot ganggu lagi ya min	negative
apk byu gabisa buka ya allah	negative
wah beneran nyata no tipu tipu	positive
tsel yang gb	neutral
min hari ini lelet banget knp ya ken di pakai kerja soal jaring	negative
ini tiap di aku kenapa h atau g mulu	negative
tangan langsung dong dan sekarang jiga harus sudah masuk kouta saya jangan bikin saya kesal karena sudah hari lebih masih belum masuk juga kouta nya	negative
daerah solo emang lagi panggil darurat gitu ya	negative
lah aku kuota toping potong tapi viu gabisa buka acan kan kesel banget	negative
iya kapok poko mah apalagi buat game pas scrim sering banget jadi h mending pindah ke lagi	negative
dari kemarin apps masalah sementara paket mau abis dan lagi luar jaring wifi mohon baik ju tcoecvxjxaep	negative
internet di manado ganggu min	negative
aku pernah daftarin paket pas jam upgrade sistem alhasil tidak masuk layang sudah cuan	negative
g speed apa asa arti semua jenis paket biar asa di gadget apa itu harus ada mbps	neutral
punya belum bisa	negative
beli pulsa konter hp	neutral
aplikasi ga bisa d buka	negative
mau beli paket doang kok yo tidak bisa gimana to sudah restart hp sudah update aplikasi baru juga ttp tidak isooooo	negative
kembali ke telkomsel aja haha	negative
samaa malah parah pakai paket internet ga jalan sama sekali internetnya di upgrade speed jug tcodvwtwzqxnv	negative
maintance sampai kapan nih tai banget mau paketin penting	negative
saya masih orang yang sama kak yang kapan hari sambat sinyal	negative
tpi cuma centang biru terus hbs gtu di lanjut malah jdi gk centang coklat bikin kesel tok	negative
wk aku kayak tiap minggu masalah mulu	negative
sinyal h aja min dari kemarin	negative
baik banget sih makasihloh tcozljodojmj	positive
coba min tolong bantu nanti dia ga bisa tlp gebetannya	neutral
ga usah kak ga bantu soal	negative
kuota richgiga dari bisa buat akses apa aja ya nyoba speed bisa mbps	positive
yang ini di aku kok ga ada ya biiasanya pakai yg dua jempol ini	negative
ngga ini ga baca sama sekali tulis no sim gimana cerita bisa dipake buat inter tcoxhbxueptk	negative
apa gamau collab sm nct min	neutral
ini kok transaksi saya jadi dobel	negative
hahaha km baik banget syg tcodrzjaaunfn	positive
masih bulan lagi sie sebenernya	neutral
min payah sinyal lot sudah brp hari ini sy daerah jakpus	negative
kok gabisa klik registrasi yah ap saya aj yg gaptek tcoqzunli	negative
aduh samaa ngefreeze waktu wwncr tcokucvvses	negative
min sabi lah kasih gratis paket ke aku yang langgan by u ini	neutral
sejak kapan tu asa akhir ngisi baru ada yg rb mbps deh	neutral
aku login pakai nomor otp nya kok tidak masuk ya	negative
cieeee perhati bangent nih nindy mksi bnyk nih kado ultahx luv u tcocvnizvw	positive
sama nder kek emg ganggu	negative
wk jaring benerin dulu min	negative
aplikasi by u akhir akhir ini kok sering banget error ya mau ngisi kuota jadi susah	negative
nyesel beli sudah habis banyak tapi sinyal kadang buat ngirim wa aja pending tcofgbrodzuxs	negative
min nomor by u tidak bisa untuk registrasi mi message ya	negative
min ini kenapa ya beberapa hari gin mulu tcopyu	negative
lanjut dan privasi data kakak tetap jaga	neutral
min kalau ak baru mau pakai by u dapet affh min	neutral
jaring kenapa min padahal g tapi ga bisa buat internetan	negative
knp si kamu ilangan trs	negative
neng tidak lo stad d rep akin centang biru	neutral
speed tidak bisa tes karena jaring lot padahal bar jaring full tcooougjwgn	negative
min paket data saya numpuk nih bisa tidak yang gb	neutral
min yaallah kenapa sih masih force close aje aplikasi di ios sudah beberapa hari hhhhh urgent nih mo kelu tcojlwduuuux	negative
baik emng	positive
halo by u saya mau nanya kenapa nomor saya dapat tawar judi online terus ya via wa lagi	neutral
ini kok ga buka buka yaa hpku yg salah atau emng apl nya lagi ada maintenance tcobuqzybecr	negative
baik pakai akun regional jika promosi buah produk yang belum sedia cara nasional	neutral
buat yang mau begadang nonton uefa euro sekarang ada topping mola tv gb ribu dan gb ribu masuk akses mola euro lho	positive
knpa sinyal g nya no network dignti ke g baru nongol sinyal ny	negative
min g tempat saya harus di luar rumah	negative
aplikasi byu kenapa g bisa buka yaallah	negative
bandnya ga support	negative
by u kamu kenapa sinyal biasa ganggu mulu yaa mama bawel terus jadi tuduh abis kuota	negative
ini kartu harus diupgrade dulu kayak pas g ke g ga	neutral
dah nyerah ganti nama jadi bye u tcomqhhbdta	negative
kapa byu bisa e simm bosq	neutral
komplain ke nindy sinyal g aja lot banget	negative
dear tolong dong sinyal byu di daerah banyumas parah banget sedang sinyal telkomsel tidak sebenernya byu bagi dari telkomsel apa emang anak tiri sih	negative
min kamu ada masalah apa sih sama aku sinyal rumah ku ko jelek banget padahal depok lho di kota juga sumpah bukan di goa atau lokasi babi ngepeeeeet tolong laaaah	negative
tempat yang internetnya lancar	neutral
sini ada yang pakai by u tidak ya kalo misal aplikasi crash dan mau beli paket	negative
sudah mulai lot aja sinyal tau ilang	negative
min ak sama byu sudah bulan trs kasih gratis gb mksie ya	positive
min tolong cek dm ya jaring saya error dari pagi tidak ada koneksi terima kasih	neutral
bahagia itu ketika dapat kuota dari tcoyxhyechd	positive
paling balesannya kaya gin	neutral
provider plg rajin maintenance aplikasi	neutral
sama aja aku dah pakai telkomsel	negative
buat maen ml awal doang ijo tiba recconecting trs ping naik turun bikin males	negative
terimakasih atas taanggapan dari keluh saya sebut ya seperti yang sudah saya sampai dah tcommojsxdmy	positive
tolong nih signal di kebon jeruk parah banget	negative
jaring min jaring h mulu dah puasa puasa bikin emosi	negative
ayo dong benerin jangan hanya beri jawab yang normatif	negative
apa tidak mau collab sama nct	neutral
min kenapa aplikasi byu tidak bisa buka aku mau beli kuota	negative
dan aq boros banget	negative
saya pakai by u tidak lemot tuh	positive
sama bang ada progres di jawab admin ga	negative
admin mau nanya knp dah aku buka twitter pakai paket data by u tapi kok ga bisa mulu ada ganguan kah	negative
sinyal nya harus stabil nih byu di stabil in dong sinyal buat nge zoom lelet nih	negative
first impression pakai d yang unlimited hari kaget banget nyata streaming youtube aja lancar tcotrhfplohvq	positive
halo kenapa kalo buka app netflix	negative
ini kartu byu baru beli ngk bisa aktif	negative
min ini gimana gbs buka app by u terus internetnya juga error apa gmn ya mau cek quota jd gbs	negative
lagi nunggu komplain selesai sudah hari ngga ada kembang	negative
kenapa ya akhir akhir ini lot banget	negative
rajin karena pakai kartu byu sinyal ngajak emosi soal tcorsbynebll	negative
sama nih arti emang tadi rata ganggu semua	negative
lah sini g aja msih krang stabil	negative
benar benar dah ga ujan ga angin ini kenapa g mulu	negative
minn bagi kuota gratiss ayokk sksks	neutral
minim kenapa kok saya gabisa buka aplikasi by u sih	negative
tidak beli apa apa orang buka tokped pakai byu aja susah	negative
tapi hp bom g emang bisa min jujur aja by u bom pernah lebih dari g kalo telkomsel pernah sampai g	negative
knp dah tiap buka aplikasi pasti ga bisa mulu aku kira krn bom di update tapi dah di update paling baru juga tetep ga bisa buka	negative
tidak bisa buat terima sms dan telepon aktivasi yak	negative
coba akses aplikasi byu pakai koneksi internet provider lain ya kak	neutral
annivnya sering sering dong min	neutral
masih th nih	neutral
min tolong kenapa ya sinyal jelek mulu dimention ga pernah dibales	negative
kenapasih buat buka spotify tidak ada koneksi internet padahal ada kuota nya	negative
lahhhh by u	neutral
biasa pakai yg bikin clbk tapi sekarang sudah gaada tcoaevnzcwx	negative
g benerin dulu noh	negative
min ini kenapa gin terus yaa	negative
kak aplikasi by u lagi error maintenance ya ga bisa masuk dari kemarin	negative
byu kan make signal telkomsel ya hmm	negative
pakat unlimited untuk game codm kenapa lot ya min	negative
udh x bolak balik stok gada terus	negative
what s wrong with your app minggu ini buka kaya gin mulu	negative
aaa min itu promonya smp kapan	neutral
emang blokir aplikasi ini kah internet semua lancar tapi kalo buka aplikasi ini malah internet nya ga tcosvbanjbyi	negative
pakai sinyal telkomsel telkomsel sini parah sinyal	negative
halo min ini kenapa aplikasi begini terus ya tcojwmrfbp	negative
parah ini kenapa tidak bisa internetan nya padahal udh aktivitas tadi	negative
min kenapa aku internetnya lot banget	negative
anjer kenapa jadi gabisa buat buka spotify ini kenapaaaaaaaaaa	negative
gb tapi ga abis	neutral
lagi jd siput ya	negative
tidak lebih baik dari	negative
tolong sinyal nya kondisi jangan luplep	negative
aku pakai yang gb dri worth it sih kuota tidak bagi kuota kemendikbud gb jdi total g tcoybrhpfc	positive
baik kualitas sinyal	negative
benerin jaring anj bkin emosi pakai ni provider taii	negative
tidak ada di daftar nih saya main clash of clans soal	negative
sudah ada akun aktivasi pakai kode referal saya	negative
naikin dikit lah minimal atau mbps untuk hibur rekan rekan yang belum jangkau g daerah nya	neutral
cara abis regis ke menu ini gmn cak	neutral
ngelab	negative
min apakah ada solusi buat saya yg masalah itu hp saya udh ga support aplikasi by u karena prosesor masih saya masih mau pke kartu ini untuk hari hari masa saya harus pindah ke provider lain	negative
naikin speed unlimited nya min sudah jaman g masih ada aja yang mbps	neutral
sinyal jelek tapi kuota boros	negative
begini kualitas byu tcohfraorxro	negative
kencang banget speed nya tcoezzjochws	positive
bisa yang promo thr tambah jadi gb	neutral
help tbtb gada signal sudah kirakira jam paksa isi kuota provider lain	negative
sampai jam berapa yah kira kuota saya pas banget lg abis padahal lagi up video tcohmxtscpkuf	negative
ini knp dah akhir ini sering lot mana mau beli flash sale gb tinggal jam tcojqtmncbu	negative
iya di nomer yang sama gitu mas boleh juga tuh beda nomer apps connectify yang mana ya bang soale banyak	neutral
sudah coba akses aplikasi byu pakai koneksi internet lain	neutral
min aku buka aplikasi selalu muncul tulis something went wrong kenapa sih padahal jaring stabil	negative
nah sama ini maslh nya niat jual tidak sbnrnya kaco ini by ungetweet mulu jual mulu tidak sadar kualitas	negative
ih sama aneh banget kenapa gabisa ya	negative
kenapa tidak bisa login sih min	negative
kuota topping twitter dari masih awet banget kayak untuk twitter enggak usah kuota khusus ya besok paketin yang lain aja	positive
mau beli kuota dari hari yg lalu ga bisa masuk aplikasi mulu kenapa ya tcoscntwb	negative
siap dong tapi awas ya ngelag mulu kalo main game	negative
selamat siang min mau nanya by u unlimited bisa dipakr di modem kah	neutral
jamin hemat tidak abal abal dong kalo pakai by u	positive
thread euro di space kok ngilang yang kemaren nindy rt juga ngilang	neutral
ini kenapa ya kalo buka by u pakai koneksi by u tulisanya somthing wrong terus	negative
apknya mas gabisa dibukaaa	negative
makin ok nih fiturnya jd makin betah	positive
internet saya kok tidak bisa ya padahal kuota masih gb aktif sampai juni internet kendala sejak kemaren sore	negative
csnya sekarang lelet banget	negative
benerin napa dari kemarin gila mulu nih kartu	negative
kamu kenapa beb udh pakai apn byu ga bs buat buka pinterest	negative
lah beneran tuh ren ih parah kita tinggal kota besar loh bukan desa yg jangkau kecil sinyal aja jelek	negative
hallo min ini kenapa sinyal tiba ilang sudah jam lebih ga muncul sudah matiin hp juga ga muncul	negative
dari xl pindah ke harap sinyal lebih kenceng	positive
sini juga minim banget sinyal	negative
min kenapa ya dari minggu lalu byu tuh gabisa dipake buka zoom fix sinyal byu soal pakai wifi bisa tcooabkynx	negative
jaring byu ini sangat tidak recommend buat buka aplikasi seperti snack video	negative
pasti pas buka appnya salah sambung ya	negative
mending lah	positive
min ini kenapa gin ya mau aktivasi sim card malah gabisa tuju menu lanjut tcodsicrdrxr	negative
ilang juga jaring	negative
hehehe iya dund aduh profile pict aku kudu ganti deh hahaha	neutral
wahhh makasih min dapet kuota gratis tcoaqdmbevn	positive
makanya byu bisa donk bikin paket yg jadi tidak kena blokir	neutral
minnn tidak bisa beli kuota nih gara gara tidak bisa masuk aplikasi	negative
google dan by u lebih paham cara ucap tcokewmmbdh	positive
tolongggg kuota ajar gmett plisss	negative
jaring baik dong kak makin kesini makin parah	negative
euro fantasy league nya mana min	neutral
min paket yang k gb sudah gaada ya padahal sudah nyaman pakai itu tcopuvyrcgzf	neutral
tiap buka aplikasi by u selalu muncul something went wrong	negative
ping nya hrus stabil	negative
baik donggg sinyal nyaa	negative
eh tapi benerr biasa hadiah kuota pas paket mau abis	neutral
rumah sambil internetan pakai byu dong tapi sayang ga bisa beli topping youtube karna aplikasi salah jaring mulu anjing	negative
kek sinyal deh	negative
sinyal tidak bisa buat buka aplikasi sejak mei tcoewcloyiftm	negative
arti emang kendala ya	negative
bisa banget by u adsnya lewat pas lg rame kasus	positive
kenapasih buat buka spotify tidak ada koneksi internet	negative
benar banget nih apalagi waktu hujan tidak bisa iternetan nasib saya pakai by u dan tsel dalam hp	negative
paling enak sih	positive
pakai by u biar lancar streamingnya my	positive
aplikasi ridak bisa akses tcorjvcrqzo	negative
plis k gb nya adain sampai bulan depan	neutral
dan lagi ga serasi ya ga bisa akses netflix pakai by u sejak kemarin sore	negative
min tolong dong ini dari kmarin gabisa buka terus tcomvlguyk	negative
eh itu jenius beda lagiiii	neutral
kak ini by u lagi error kah aku mau ngisi data di indomaret kata error	negative
cb kamu dm aja deh twitter	neutral
kok buka aplikasi nya loading terus ya mau beli data jadi ga bisa	negative
soal saya copot kemaren saya ganti jadi kartu	negative
musuh aja yuk kita	negative
min spotify kok no internet connection tapi buat yg lain aman aja why	negative
ni kenapa lagi by u mulai jadi cepu zzz tcozxnpqapdt	negative
makin ga nyaman aja	negative
beli paket byu bayar pakai linkaja susah amat sih suruh masuk padahal sudah masuk goblokkk banget sih tcoegigcdypk	negative
jahat amat dah yg bikin	neutral
sales ya bang	neutral
mim kenapa internet di tangerang lot banget tolong baik ya	negative
kak saya mau daftar m banking kok gabisa ya	negative
tolong bantu deh ini gimana login hotstar di desktop	neutral
bangga banget sih jadi anak by u	positive
punten ini admin sudah mau kayak gin jam tinggal kuliah juga kan tadi jadi boleh minta tolong baik tcosifgqirbi	negative
ganti aja emang dah turun sih kualitas	negative
minta tolong untuk baik servernya dari kemarin gabisa masuk aplikasi tcovbztso	negative
duh lot banget dah	negative
wa sama twitter mau nyoba topping game keburu hapus gamenya	negative
minn ini knp aplikasi by u gabisaa buka	negative
simcard saya tiba tiba mati harus gimana	negative
sudah di dm jam yg lalu dan masih belum ada solusi padahal cuman receh	negative
mau masukin nik sama kk aja ndak ada	negative
rek ganti ku xl jempol aing mah yug	negative
pen banting hp asli pas lagi putus tuh sinyal kudu clasic hari dulu biar bisa rank	negative
saya sudah bayar tapi saya cek kok ngga ada konfirmasi email atau record transaksi di web byu	negative
masih tanggal duit sudah abis	neutral
by u lagi eror yaa min	negative
ganti hp duitnyaaa	neutral
wanjet greget nih ada temen mabar pula	negative
uhuk uhuk tidak asa kita sudah tahun ya beb tcouwwgmlhamu	neutral
promo sampai kapan nih nin	neutral
yg sering itu pas di rush lawan jaring malah muat	negative
iya nih kalo main game sering lag	negative
makin kesini by u ko jadi gin	negative
paket thr unlimited dong rp	neutral
min tolong baik aplikasi ini jangan bikin stress	negative
min kok sinyal hilaaaaang	negative
hahahhaahaaa tidak usah tanya kenapa kak ujung nanti didm suruh kirim nomor hp type hp sama alamat minta alamat sampai ke patok kayak orang mau kirim paket aja tapi tetep aja sinyal tidak langsung benar	negative
harus nyontek provider lain dong	negative
donggg gancang pisannn plus marurah bismillah kuota gb	positive
pertama kali beli topping disney hotstar tapi pas streaming yang kapakai kuota utama	negative
aduuh iya nih apalagi jadi ba nya kini banget	positive
gimana asa mu kalo internet kencang di upload doang tcocukuwdug	negative
yang k	neutral
jaring lot sekali nih	negative
app by u kenapa dah gabisa di akses	negative
	
iya kadang buat ngrimi chat aja pending	negative
bs g si jaring dibetulin dulu udh minggu lot banget nin ngegame juga pingnya mls banget anjir sm lu	negative
kemaren baru dapet kuota monthversary dari tapi hpnya jambret orang	positive
balikin ke harga normal mbps k	neutral
sudah ganti kartu halo aja	negative
enak sih pakai provider doi	positive
horor nih min mau trf gakada pulsa jadi gakbisa trf soal aplikasi lo gakbisa dipake asuuuuu	negative
lah punya belum diupdate aja tetep gabisa	negative
min saya mau registrasi gagal mulu napa nih	negative
min gimana sih kok sampai sekarang tidak bisa buka aplikasi by u pakai jaring by u aneh banget	negative
dari sore kok lot siiih tcorrmjijr	negative
ada topping buat game genshin impact tidak	neutral
tolong don admin saya mau login ke aplikasi masa jadi salah terus dah dari beberapa hari nyoba l tcoxopufxpqt	negative
bagus nih solusi	positive
lah nyata bukan saya doang	negative
wih mantep juga tapi mending by u pikir nu	positive
btw min tadi jaring untuk wa sempet error ya	negative
kenapa ga ada jaring ya dari pagi	negative
ntar aja dah tunggu dah pada rame g baru pindah kalau ada dana dan	neutral
mulai masalah juga	negative
gb makanya kasih paket yg murah ya min pliss pliss atau naikin speed unlimited kaya dulu pliss terp tcoyxtlvtphmv	neutral
x komplain ditwitter balas sama aja suruh refresh jaring	negative
maaf min ko paket saya blm masuk ya dari link aja ny udh potong tcofnwyamlhf	negative
jangan undang konspiresyen dong	neutral
blm pernah di respon njir	negative
mejik cess tai blessing tai cuk rapernah hoki anjir	negative
tadi aku coba buka crash emang kak	negative
alhamdulillah gonku lancar	positive
gin buat pas luar rumah mesti masih kurang padahal di rumah pakai wifi tcosrnagnafvu	negative
pagi min saya mau unreg kartu by u saya bgmn cara	neutral
dapet kuota gratis dari	positive
eror mulu heran sama kartu ini	negative
happy monthiversary	positive
hi by u aku punya simcard by u yg udh lebih dari hari ga aktif apa aku bisa dapat nomer baru tapi deng tcopczdxxcno	neutral
tim byu apa nih nin wkwkkwkw	neutral
dan ga oke lagi bagai partner maen mobile legends ngab ngab jumping parah mari kita pindah provider	negative
kiww sudah bulan aja sama	positive
min ini gimana solusi saya tinggal aktif doank tapi data kartu keluarga salah keteranganya gimana nii mau dipakeee	negative
min ngurus nomor byu yg ilang gmna cara	neutral
sedih pis streaming p	neutral
tidak ada kuota kaget nih yg murmer min	neutral
duh sinyalna kok muter trua sih lieur yeuh	negative
dari awal pakai by u sampai skrg gabisa dipake maybe uda bulan	negative
coba kali selalu has seperti ini dan tidak ada terang yg lebih speksifik tcotrfgijoil	negative
gimananih masa sudah tf tapi pulsa ga masuk tcobwscmpgg	negative
ada rencana tidak min naikin speed	neutral
byu kenapa tidak bisa akses spotify sama tokopedia deh aneh banget	negative
update dulu	neutral
aplikasi by u punya kok gabisa buka ya lg ada baik kah	negative
bi ini saya buka aplikasi by u kok ga bisa yaa saya mau aktifin nomor saya kembali karena sudah hampir b tcolmcjzzwbhj	negative
aku tidak pernah beli kuota sekarang	neutral
saya barusan transaksi beli paket unlimited mbps jam tapi paket belum aktif padahal saldo link aja sudah potong	negative
o ya by u dark mode kapan nih	neutral
haduu percuma hp nya nga support mau ganti tapi masih miskin	neutral
marahin nindy karena lelet mulu nih by u	negative
adain lg dong bonus kuota masa cuma tahun doang	neutral
tambah pulsa tiba potong sendiri	negative
beli kuota by u tapi gabisa dipake spotify	negative
min tolong dong kok ini app nya tidak bisa buka force closed muluu	negative
hai min ini kenapa selalu loading lama ya dari dulu selalu gin jadi sulit kalau mau bek paket data lagi mohon bantu tcouprawgpsi	negative
halo mimin nindy apps nya apa lagi error yaaa kokkkkk tidak bisaaa terusss pdhaal aku udh update	negative
topping ig sama youtube nya naikin dong jadi gb kaya dulu	neutral
min knp internetku tibatiba gabisa jalan ya padahal sinyal full dan sblmnya baik baik aja bisa dipake internet	negative
kapan nihhh pulsa bisa dipake buat bayar aku lelah dengar dengan iklan dan sudah te tcojglbhpb	neutral
falcon and winter soldier cuy next loki mau nntn hehehe	neutral
min adain kuota yg mbps please	neutral
bhaaaks sudah ninggalin bayu dari tengah tahun lalu karna sinyal sama tcokteiupmwf	negative
halo min tadi saya beli topping telpon jam wita di indomaret sampai sekarang belum masuk paket gimana dong tcobrgcgnjt	negative
kaget pakai beneran unlimited	positive
kenapa si jaring nya suka ilang tiba tiba kesel banget tcocwhcifuu	negative
kenapa sinyal h terus dari siaaaaaang	negative
percuma kuota banyak kalo jaring ilang ulang kaya hayabusa	negative
ngabisin kuota	negative
udh hari msh aja kayak begini saranin nya pakai hp yg lain dulu	negative
belum bisa order ke kupang	negative
byu kasih fitur yg bisa ganti kuota dong semalem beli kuota safe n slund tapi lot trs aku beli yg gb tapi gabisa di ubah ke yg gb	neutral
bang byu di cikupa lelet dah	negative
min dari pagi buka app by u kaga bisa terus gimana nih	negative
gada jaring nih	negative
untuk di indonesia cepat internet dari g masih batas sekitar x x lebih dari g untuk sekarang tapi mungkin untuk depan bisa lebih efektif	neutral
si paling gercep emang miminnyaa	neutral
bulan pakai byu kaya aman aman aja	positive
sebapuk itu jaring by u masuk game aja ga kuat duhh tcobtzfrwpc	negative
ini sih sumpah endul gapernah ganti ganti paling pol sampai itu juga kadang sisa soal awet buat stream tcobgyibobq	positive
aku sudah bisa gaes yaa mau ga mau ribet restore storage dulu gigaan buat updat tcocxdftywnx	negative
gua beli kuota yg gb via kasir alfamart struk nya hasil tapi kuota tidak masuk	negative
iki sih juara mas murah kuota banyak	positive
makas tau aja kuota pas habis tcosygphsf	positive
paket nelfon ke semua operator knp gk bisa buat nelfon cs bank	neutral
down trosss kalo malam biasa elahhh	negative
sudah hari sejak bayar kartu belum terima kata masih ada problem yang saya tidak kasih tahu tcokmidciz	negative
gb rb dah jadi langgan saya min w	positive
yah mo gimana lagi orang byu numpang sama punya telkomsel	neutral
kenapa kalau open app kamu pakai jaring kamu sendiri ga bisa	negative
masuk ke provider telkomsel	neutral
happy anniversary sayangg si selalu ngasih data gratis tcoxplllcvbzm	positive
dikadoin kuota gb sama makasih kadonyaa	positive
ini kenapa yah dari jam sore g bisa akses data sama sekali cek app nya aja muter terus ga masuk	negative
ga ada pilih yg lebih buruk	negative
hadehh g aja masih lola baik dulu tuh jaring byu	negative
selamat siang min mohon bantu saya beli kartu by u tapi jaring di device saya tidak deteksi thx tcownjkvbkt	negative
	
emang horor min tapi lebih horor lagi kalau para guna by u ga tau kalau ada rewards coin yang sangat faedah tcodnhqhavvw	positive
woilah ngakak tanggung jawab	negative
hallo by u kenapa jaring hilang dari malam sampai saat ini belum kembali apa sedang ada baik jari tcouhrcvb	negative
not recommended	negative
tanya aplikasi dibukak dari beberapa hari kok tidak bisa ya tcoqcowbpmyqt	negative
kenapa aplikasi gabisa buka sihhhhh aku mau beli paket ni	negative
apakah by u sedang ganggu dari kmrn saya tidak bisa akses masuk	negative
halo kawan yg di jawa barat khusus bandung apa iya skrg lagi ganggu byu saya rasa donlot pakai torrent mentok kbps dari bulan kemaren suruh bongkar modem dan hape pindahin kartu doang ga selesaiin masalah kata jaring lagi b	negative
susah sekali masuk aplikasi	negative
mantap min sinyal tcouttwrejbeo	positive
nggatelisasi tiap buka bayu tcoznubfayi	negative
ka nomor by u yg sudah nonaktif kalo kita isi pulsa bisa aktif lagi ga	neutral
bandung area error kah	negative
kalo telkomsel udh g arti by u udh g juga benar	neutral
ini gimana ya tcocwzxtrys	negative
kenapa jadi lot banget	negative
saya sudah sabar banget loh ini dari kemaren gin mulu tcoflvycfg	negative
selalu nulis upaya selesai cepat tapi ga kelar kelar woi elah iini buset dah ah	negative
benerin karburator di jalan	negative
tidak ada give away nih min	neutral
admin ya parah	negative
mau tanya untuk area tanah bumbu kalimantan selatan apakah jaring by u sedang trauble karena ini mulai sebal sekali	negative
tempat sudah nyaman eh jaringanya ga bkin nyaman ada ya ini byu	negative
untuk bisa nikmat jaring g	positive
tiap abis hujan down terus deh	negative
coba di tingkat dan di stabil lagi jaring	negative
ada cara lain ngga buat cek kuota selain pakai aplikasi tcooaklupv	neutral
ga akan baik masalah initeh	negative
iya saya juga selalu pke paket yg ini	neutral
k gb balikin lagi dong nindy	neutral
baru ngeuh ada yang ngasih bonus kuota pas ulangtaun thank you tcodhezpzxkn	positive
jadi gimna nih ga bisa beli qouta apa pindah aja ya ke kartu yg lain	negative
paket yang k gb mana ya padahal sudah sering pakai itu	neutral
lokasi pengaruh	negative
lot mahal	negative
ko kamu lagi lama sii aku bete deh baru aja pindah padahal	negative
kalo aku bukan jarang lagi tapi tidak pernah sama sekali dapet sms pinjam atau tipu gitu lama pakai by u	positive
lagi ada acara keren banget ini	positive
wildrift juga masukin dong	neutral
dari mei sampai hari ini	neutral
	
tapi aplikasi gabisa dibukaaa	negative
alhamdulillah tunggu min	neutral
i love u tapi kenapa signalnya dri kemaren jelek nina	negative
proma promo sinyale ndak masok nde omah lur	negative
satu lagi kalau ini nanya byu g bisa buka zoom ya	negative
paket abis langsung gant aja operator lain	negative
min apakah lagi masalah jaring ya karena kok tiba hilang signal gin	negative
susah bet buka aplikasi byu	negative
min coba switch akun dlu	neutral
kalau malam hari aplikasi selalu begini tcojokvizzip	negative
fox sport dong biar bisa full nonton motogp	neutral
aku bentar lagi ultahh awas aja kado gasampe ya nin tcocirchap	neutral
promo kuota gede gaban sinyal ilang hoam	negative
ganti hp nih kayak	neutral
min benerin dulu jaring min	negative
mau buka aplikasi tapi tidak bisa terus padahal lagi urgent ni kenapa ya astagfirullah ya gusti	negative
demi apa ini by u drtd ilang sinyal	negative
coba pakai koneksi internet provider lain ya	neutral
min kok punya saya gabisa g	negative
gamau nambahin paket yg cepat lebih tinggi apa	neutral
jaring masih ilang ilangan gitu loh	negative
apakah byu sdh bisa pakai g telkomsel	neutral
widih ada kak bayu halo kacks	neutral
penting banget si krn sgt sgt pengaruh hidup kita hari hari	neutral
facebuk lah terus maen ninja saga	neutral
mikirin g noren aja mentok kbps kok by u tcohpddyvts	negative
by u lagi maintenance kah min	negative
nahan emosi karena sinyal byu makin lot	negative
cara cek kuota tanpa aplikasi gmn ya aplikasi tiap buka kok gabisa	negative
dan enak nya lagi tiap ada event ato apa selalu dpt gratis kuota	positive
buset sinyal parah bgttt	negative
paket banyakin dulu rate atas k sudah bisa dapet gb hari provider lain lebih murah	negative
tidak mau bikin liga euro fantasy nih tidak mau sedia toping molatv juga	neutral
benar l dah lot	negative
that sueeeeeeeeee	negative
kapan ada paket atau toping bundling	neutral
min dipake refresh ig kagak bisa bisa kenapa nih	negative
min kamu gaada niat buat bikin topping netflix gituh	neutral
kak cara check pulsa by u	neutral
biasa nya beli selalu unlimited	neutral
lumayan bisa buat donlod ambil paket gb hari tcoxlqqvhpv	positive
lagi ganggu yak kok buka spotify gabisa mulu	negative
koneksi benerin makin kesini makin ngaco	negative
sering pakai gb itu pun kuramg tapi karema di tetringin sama adk sama ibu sih	neutral
ken tahu cara gunain kuota gb dri	neutral
minn emang pakai bay u jaring bisa bagus juga	neutral
ini gimana meh beli kuota gabisa di bukaa aaaaaaaaa tcoqmdarqw	negative
suka ga konek spotify sma netflix knp ya min	negative
cuma mentok sampai ios tolooooong	neutral
gaperna main game karena saya tau rasa main	neutral
emang benar benar lu ya tcozelstm	negative
baru kemaren sabtu habis nonton fast and furious	neutral
lagi kecewa banget nih sama sinyal by u dari kemaren jelek banget	negative
pernh toping yutub ratus giga	neutral
di mana tidak penting yg jelas akhir ktemu waktu masih ada paket by u gb rb paket murah kakakkk	positive
mantap nih admin gercep ga kaya admin yg smart doang tapi ga fren	negative
nindy jaring kenapa ihh wfhnya jadi ngadettt	negative
tolong dong aku gabisa sama sekali nihhh bahkan pencet registrasi aja gabisa	negative
tolong min ini kenapa baru banget saya aktivitas dan kartu dateng tidak bisa dipake internetan plis respon saya	negative
ada yg make by u trus kendala ga sih lot dan gabisa beli credit paket	negative
paket gb nya mana	neutral
sama nih gabisa beli paket jadi urgent banget padahal drtd	negative
rb gb tapi sekarang tidak ada	neutral
min sudah hari sinyal hilang hilang terus sudah kali kali di plane mode restart seperti memang lagi ganggu parah ya	negative
eh aku ultah kok gaperna dapet yaa	neutral
gabisa nntn euro dong	negative
unlimited mbps buat minggu walopun kadang lot tapi ndakpa	neutral
bisa angka jam cantik azeekk keren tidak sie tcohhsjnasox	positive
aplikasi saya tidak bisa buka kenapa ya apakah sedang eror	negative
kak kalo sim card rusak gimana cara ganti sim card baru	negative
menang murah doang anjg	negative
anjir yaaa bikin kesel banget sumpah masa kaga dapet g tcohfnjidszn	negative
minggu ini sinyal by u ulah apa daerah padang aja ya xd	negative
kalau byu g perlu ganti kartu ga bang	neutral
udh sering btw sinyal km knp dehhhhh dari jam siang ini loh gaada	negative
min kok hari ini sinyal lebih jelek dari biasa min bahkan barusan dpetnya sempet g doang	negative
pleasee kenapa aplikasi harus error skrg	negative
halo min sinyal lemah banget nih	negative
sinyal di bogor jelek banget	negative
eh versi jd yg blm update mending tidak usah update ver aja deh	neutral
agar bebas main game tanpa khawatir ping merah	positive
rb gb kok ilang min	neutral
wah nyata admin bayu dreamzen juga tcodqlliyeen	neutral
main mobile legends paling enak pakai byu	positive
ini tolong di tingkat dong min di paket kata mpbs tapi ini di cek x dan mpbs loh min	negative
akhir ngerasain sinyal e pas samsung ngeluarin galaxy young alias sowe banget iki opo jek usum sinyal e yaallah tulungggg	negative
kenapa sekarang sinyal jelek suka ilang tiba tiba	negative
tar dl min hapeku bom g	neutral
mau protes kenapa cepat unlimited masih	negative
gabisa login dari kmrin kenapa dah	negative
applikasinya kenapaaa siih tidak bisaa terbukaaa trusss mau beli pulsa gimanaaa	negative
jaring kalo lagi genah enak	negative
ini aku beli yg gb tapi buat buka spotify gabisa	negative
goblog sinyal benerin ajg lambat benar kaya siput	negative
kenapa byu tidak bisa buat netflix ya	negative
gabisa internetan wadoo jam jam main game padahal jam segitu	negative
aku mbyen uninstall trus install maneh	neutral
tiba hilang yah	negative
baru baik server sistem ka	negative
wk emang dasar bangsat aja itu tiba tiba ngilang	negative
udh hari appnya ga bisa buka jd gabisa apa apa	negative
hallo kak saya mau nanya kok tiba tiba signal saya jelek banget ya	negative
internetnya ganggu sampai kapan min bakal ada kompensasi ga nih lama soal ganggu kuliah jd ga lancar	negative
aku beli pulsa byu k tapi yg masuk baru yg k bayar pakai shopeepay bisa bantu nindy	negative
min bisa jelasin kenapa dari kemarin sinyal h terus	negative
saya di email minta kompensasi kait hal ini	neutral
akhir nindy kasih paket toping game lumayan buat main game pas lagi kismin	positive
bayu ter grecep emang	positive
bentaaaar harus lurus nih min kalo kita download update in game keitung topping apa quota utama ni kalo keitung topping si beneran ggwp bikos we already know that update game itu makan banyak quota	neutral
promo sih ok banget lah ya	positive
sinyal ngapa lot banget barusan mon maap	negative
kapan min g nya	neutral
rumah kenceng banget sih turut	positive
ini knp gbisa di buka apkny mau beli kuota	negative
apa faedah pakai g bila speed unlimited nya masih di mbps	negative
k gb bulan mantep banget tapi ko uda gaada si	neutral
mkny pakai live on aj	negative
gocek btc mes dalam detik	neutral
beneran ngga nih g nya yg sekarang aja asli lte ghehehe	negative
ok dapet gin ya sy tapi memang aplikasi gabisa akses sih tcoldgphfgt	negative
emang pernah mbps k	neutral
topping ig tinggal byte sudah gabisa buat akses ig	neutral
benerin dlu sinyal g nya bru g	negative
anjing	negative
padahal di app store nya minimal ios hiks tcousgbnysjfh	negative
halo aplikasi kenapa ya kok tidak bisa buka terus sudah dua hari	negative
yaallah trnyata ada temennya asli kesel mau gigit	negative
habis itu dah tidak ada lagi	neutral
bisa yg becus ga sinyal	negative
sinyal jadi adat min tarif malah murah tsel hadeuh	negative
dahla appnya sering gbsa buka	negative
happy anniversary buat kita tcoicmzpvk	positive
after uninstal applikasi nih kok tetep gin tconudzhjaxp	negative
aku juga sering gitu min padahal buat internetan masih aman	negative
eaakkk by u ilang sinyal nya	negative
cek dm sinyal saya ilangan nih	negative
ini kenapa saya tidak ada jaring by u yaa tiba tiba hilang sinyal nyaa tcocxjlxxp	negative
kak cek dm malu sini kak takut kira saya jelek by u	negative
makanya byu bisa donk bikin paket yg jadi tidak kena blokir masa buka reddit aja blokir	neutral
ada reward apa nih bagi bagi kuota kah atau jaring malemnya di stabilin lagi biar lancar pas tcotaftxswmw	negative
makasih hadiah nya tcosxpdazqazj	positive
kenapa akhir ini signalnya jelek parah ya	negative
permisi min mau tanya untuk paket yang unlimited ada paket unlimited yang speed internetnya mb	neutral
aku mbyen uninstall trus install maneh manjur	neutral
hallooooo kenapa ya ini kuota topping youtubenya tidak jalan jalan terus minggu ini padahal masih banyak t tcosvuopbxbl	negative
min bonus dong paket data dong	neutral
min by u app nya lagi error ya	negative
coba pakai koneksi internet provider lain ya kak	neutral
ga mikirin device lama gimana mau beli paket kalo gin tcozjiefriix	negative
bnerin jaring dulu min sering g mau konek apps	negative
mas blom jalan internetnya	negative
bisa tel emak alhamdulillah simpati telpon ke rp karena sudah ada combo sakti enak pakai by u ga tcowwkdlxoys	positive
ga bisa beli pulsa ga sampai pilih metode bayar di aplikasi	negative
woi bangkrut nanti by u nya	negative
sudah jam jam begini min mau buka app byu buat chat cs saja tidak bisa saya sudah dm info lengkap saya	negative
kesel lah	negative
jaring lo benerin dulu	negative
aku yg bukan gamers aja ngerasain kok	negative
lah knapa byu tidak bisa tlp via wa	negative
nindy knp gb rb nya dihilangin sedih tcouvrevakhi	neutral
cepat download dan upload byu berapa mbps buat paket internet biasa yg gb gitu	negative
updatean by u biar sinyal nya di bagusin	negative
tengkyu untuk hadiah ultah nya by tcohtwyvu	positive
sudah hri buka apk kek gni sudah terupdate pdahal	negative
yang penting kalo nongkrong itu tidak usah pakai kartu soal rada rada tidak guna sinyal tcomcnjruyfm	negative
kenapa saya klik reward koin mbps dapat gb hari	negative
min kalau sim card hilang ngurusnya mana ngurusnya ke	neutral
msh setia pakai	negative
sama kak lama ga masuk apa ga masuk	negative
kesel banget kan	negative
kpn saya dapat min sudah mau bulan	neutral
pakai by u lah goreng nya kalo bikin meeting suka putus putus jelek	negative
kira lama ngga ya saya mau beli kuota ni dan hanya bisa di aplikasi byu kan tcofntdmlchx	neutral
kok makin kesini malah jelek ya jaring	negative
dari tadi sore aplikasi nya tidak bisa di buka	negative
apa ada atur baru apa gimana ato twitterku kena blokir apa gimana min gabisa dipake buat buka twitter	negative
dpt hadiah tidak	neutral
min ini app nya kenapa gabisa buka ya lagi urgent banget mau beli paket	negative
nin byu ngeblock spotify ya kok harus pakai vpn	negative
silah guna simpatri	negative
baru beli yg unlimited bulan hikzzzzz	neutral
tolong wooooooy saya mo isi kuota ini ngapa dah	negative
min tambahin varian kuota dong	neutral
biasain dong kalo malam tuh jangan lot mulu	negative
iyaaaaa donggggg by u gituuu lhooo	positive
kenapa tiap streaming yutub dari g kok tiba jadi h sih selalu gitu saat resolusi p aku pakai paket yang unlimited rb rasa sia sia bayar mahal tapi selalu kayak gitu	negative
tolong ini kenapa dah drtd malam tidak bisa buka apknya	negative
by u anjeng sudah ngisi pulsa banyak banyak gabisa buat langgan spotify mana gabisa transfer lagi pulsa do better	negative
belum butuh g paket mbps nya naikin ke mbps lagi plis	negative
lah percuma hpnya blm support eh tapi sini juga blm ke cover g sih	neutral
sinyal g kenapa ini aduuhh tiba no connections gin	negative
byu lagi troubel ya	negative
aplikasi saya tidak bisa buka info nomor telfon dan email sudah saya kirim di dm tolong di cek	negative
knp gin mlu daritadi pagi jd gabisa beli kuota woyy tcoxqiubkcpi	negative
mint app by u nga bisa buka knp ya	negative
ini lu punya aplikasi napa dah	negative
misi min ini saya sudah beli paket sudah bayar di alfamart tapi kenapa belum proses ya padahal bayar sudah hasil	negative
min telkomsel tgl sudah bsa g	neutral
min kok skrg byu tidak ada kuota gb rb lg knp atau ada di hari apa	negative
ka nindy baik banget tcokagzmxiqvh	positive
lo juga sama cel astaga by u nih kenapa deh mau beli kuota malah gin huhu	negative
ga bisa konek sama sekali pke pket unlimited	negative
horor pas liat quota cuma kb	neutral
tolong klarifikasi dari bas giga hilang	negative
kenapa dari tadi tidak bisa untuk buka tokopedia dan instagram ya whatsapp juga sering eror tapi untuk browsing youtube lancar	negative
alah mbps mah judul doang asli mah mbps	negative
min kuota roaming jepang dah ada	neutral
btw sinyal tbtb ilang kalau di aku	negative
kalau sabar dpt gift apa min	neutral
nin aku kok tidak dapet kuota anniversary tahun ya sudah lewat hari yang lalu padahal	neutral
nindy tidak mau cobain space sambil ngabuburit	neutral
tidak pernah cek sih berapa karena pakai unlimited mah tidak mikir gituan	positive
ini app by u kenapa force close mulu ya mau beli paket duh	negative
baru jadi ke bulan nih sama by u	neutral
ancuuuuuuurrrr tcovyvccwsvis	negative
min byu lagi kenapa sih kok h mulu ya dari siang	negative
unlimited jadiin mbps dahh pateninnnn harga k gamasalahhh sudah	neutral
min paket unlimited mb	neutral
hari aja gb kalo hri dah tcobtwvntasf	neutral
huaa alhamdulillah t t terhuraa bigthanks to terimakasih jaringannyatt	positive
parah banget hiks sinyal	negative
jaring udh mulai jelek nih	negative
lg ganggu kah kok internetnya nggk bisa ya	negative
cara stop kuota unlimited byu gimana ya	neutral
min paket yg rb mbps tidak bisa untuk streaming netflix	neutral
lot itu ini baru aja ken nyoba unlimited byu takut tcoroyzzhoq	negative
kalo nelpon sama by u bisa tidak	neutral
minn apaga mau kasih kuota gratiss yg banyakk banyakk	neutral
jarigan benerin	negative
tapi min di badau sudah minggu g hilang	negative
min aku sering ngeliat iklan by u ada kuota yang gb hari itu gmn cara min	neutral
min ning bantuin sinyal di tempat ko ilang ilangan	negative
min ini dari tadi siang by u tidak koneksi internet aplikasi juga gagal muat walau pakai wifi	negative
min paket game tidak bisa buka aov	negative
mint paket unlimited naikin speednya mint tapi harga jangan naik mahal mahal	negative
kenapa tidak bisa buka netflix aplikasi lain lancar tcoayfccvmqc	negative
unlimited bulan lop dah walopun kadang lot hehe	negative
kenapa tidal bisa masuk ke aplikasi	negative
tolong benerin aplikasi saya mau beli kuota	negative
min cara cek kartu sim format nya apa kalau simpati kode nya	neutral
iya lelet nih	negative
akhir bagi juga tcogmbezlfv	positive
buffering terus ada apa gerangan biasa satsetsatset	negative
hampir giga mau ada paket lain	neutral
bisa g gk	neutral
kaakkk applikasinya kenapa ya kokk ga bisa ke bukaaa	negative
kenapa saya tidak bisa login aplokasi	negative
iyaaa coba ikut aja kuis kultumnya sp tau dpt	neutral
min knp sih ini sinyal jelek banget dari kmaren	negative
kartu sim card saya patah apakah bisa kirim ulang	neutral
punya masalah apa sih sinyal jelek banget dri semalem	negative
saya isi pulsa toping telpon semua operator tapi tidak bisa guna parah	negative
yoi kalo lg maen catur sih oke kalo lagi warrr nyebelin	negative
makasih kado gb nya tcodqfvnsktx	positive
kenapa skrg sering banget kek gin ya mo ngecek kuota jd susah kak tcohxzgbnfpll	negative
postingan euro hilang min sy cek di uspace juga ndak ada ada yang salah	neutral
happy monthiversary buat kita tcomfrmbytrk	positive
saya sudah beli kuota thr via mbca dan sudah hasil transaksi di bca tapi kenapa blom hasil di app byu yah mohon bantu	negative
aplikasi by u lama sekali buka sudah clear cache juga ini banyak fitur dalam app atau gimana tcopevkzqyw	negative
halo admin mau tanya cara blok nomor orang gimana ya saya sering banget dapat miscall dari nomor yang ga kenal terima kasih	neutral
bulan dpn beli	positive
kalau mau beli kartu by u lagi itu harus keluar dulu dari nomor yg belum ya ga bisa tambah akun nomor tcoelijwvr	neutral
kalau mbps terang bisa kuat buat p	neutral
byu sepi amat kasih saran dan tanya baik baik kagak ada tanggap sama sekali	negative
topping twitter	neutral
gabisa buat twitteran sedi banget yaampon	negative
aplikasi sedang error kah kok dari lebaran aku maau buka aplikasi gabisa terus yak	negative
betull saya dri kemarin mau beli kouta pusing duluan apknya gabisa buka	negative
knpa sinyal kek anynk	negative
by u lagi ganggu ya	negative
wah kok punya lancar y teh	positive
woooiii jangan jbjb melulu min please do something and fix your g network coverage	negative
tidak ngapain dari siang tidak sinyal canda ini kah	negative
ngelag	negative
cepat internet makin lama makin buruk aja	negative
officer by u seluruh indonesia hanya ada	negative
halo min kok saya tidak pernah bisa buka app kalau masih pakai inernet dari by u ya tapi kalau koneksi say tcoibwyqbfv	negative
sinyal mulai gajelas dah	negative
sudah antisipasi pasti adminnya jawab gitu	neutral
huwaaah ko diapus sih yg unlimited jam	neutral
ken mbps rb balik lagi	neutral
min saya habis transaksi untuk beli kuota kuota kok belum masuk ya sudah menit hmm	negative
mau metode bayar kok ga bisa ya loading terus	negative
kira kapan g di bal min tahun depan kah	neutral
kok gabisa lanjut bayar ya cuma loading doang	negative
min lagi ada baik apa gimana sinya g nya lenyap dari tadi siang	negative
akibat jaring kaya siput	negative
ini kenapa ya min dipake untuk ngegame tidak jalan padahal sisa masih gb tcocxadsgwbhw	negative
aplikasi ny tolong segera di benerin dong something went wrong trus ini nyusahin mau beli paket apa tcoumcotejrub	negative
masa sih telkomsel kalah jaring sama smartfren kak	negative
aku wae lamun ngayutub asa hese mau atau suka kadang buffer teh	negative
hpnya belum	neutral
nyokap dah langgan kuota dari bundle samsung tapi kuota ga bisa dipake	negative
ini lelet lewat di	negative
kartu by u kenapa ngga bisa buat akses netflix ya	negative
wah apakah nct dream bakal jadi ba by u	neutral
sinyal kamu butut	negative
kenapa saya tidak bisa instal aplikasi by u kak padahal internal sy masih oke	negative
bikin paket hemat donk min	neutral
paket habis minnnnn tulung ik apkne raiso buka ki loooooo	negative
sinyal kamu kek kntol	negative
iya noh liat rply nya bot kek gity terus yang jawab tiap kita komplain	negative
masih mbak sampai sekarang di jam kondisi force close terus	negative
ini gimana koq aplikasi gag ganggu trus	negative
koneksi ga kuning	negative
mau registrasi nomer by u kok gagal terus ya	negative
ini aplikasi byu kog ga bs buka kenapa ya tcojpedphqk	negative
sinyal byu ampas sekali no service dari tadi pagi sampai sekarang huahaha sampai kapan ini min	negative
ini by u kenapa lagi sih	negative
gin lagi gin terus tcoqslmphogo	negative
app by u	negative
arknights min blm ada di paket sedih	negative
kok aplikasi ilang ya di play store	negative
gokil sih admin fast respon lagi	positive
dari tadi jaring hancur lebur pak haji	negative
nin daerah jaring ga stabil banget jadi alih ke provider lain dulu btw tunggu bulan depan ya ku tcorrdbmtgcu	negative
ini aplikasi by u kenapa gin terus ya mau beli kuotaa tcocfgemrrwnf	negative
aku tunggu beneran nih ya	neutral
aku malah tiktok kak yg gabisa padahal jaring full tapi tidak bisa	negative
ga tau padahal mau isi ulang	negative
kenapa sinyal h ya	negative
sinyal di benerin dlu biar ga lancar gamingnya	negative
baik kualitas saja dlu jgn banyak program	negative
apakah admin markcity	neutral
cara ganti by u biar g gmn	neutral
min bikin kuota malam donk	neutral
sama aplikasi tentu gk bisa buka harus restart lagi restrt lagi baru bisa	negative
min ni app lagi kenapa ya udh instl uninstl jaring stabil pakai wifi juga ttp aja ga bisa di buka mau beli kuota ini	negative
aplikasi ga bisa buka	negative
kok jaring internet by u gabisa buat buka webtoon yaaa padahal buat apk lain lancar	negative
kencang anjir	positive
min saya beli pulsa data kuota	neutral
ada masa aktif tenggang kartu ga	neutral
gb rb ama unli mbps kalau bisa sie	neutral
min ini aplikasi kenapa gabisa buka ya mau beli kuota jd agak sulit mohon bantu	negative
ini kalau buat download lancar mggak ya kapok pakai yg mbps buat download lama	negative
apa saya pakai jaringanya buat maen aov tidak bisa buat login kudu pakr nomor padahal pakai jaring yg sama haduh	negative
bebas kuota internet dong	positive
kalo mati listrik lot ya	negative
sayang indihome nya sudah gua cabut tinggal orang tua aja yang masih pakai indihome kaya gua rencana pakai provider lain kaya biznet xl fiber atau yang lain	negative
byu tidak bisa buat buka netflix padahal kemarin bisa tcoxmxirtb	negative
wah brarti satu g pakai terkomsel dah min dia bohong	neutral
sinyal gabisa dari tadi help udh on off in hp coba mode pesawat search manual trs balik ke otomatis tetep gabisaa ada tanda x gt di sinyal bar nya	negative
paket yg anniversary mending ubah jadi upa voucher aja deh kaya rich giga kalo otomatis klaim gitu bis tcozumhijqt	neutral
aku beli data soal indhm dari awal smt lot gajelas malah bikin esmosi	negative
ya allah serius ni byu ada g cara ngecek hp kompatibel sama g gimana dhhh	neutral
baru minggu min bom internet di ruang tengah soal beda tcoybcalqce	neutral
yaampun min nyasar	neutral
minn di daerah saya jaring g nya byu masih lelet nihh	negative
aplikasi dulu woi jangan tambah produk percuma tambah produk kalau aplikasi eror melulu	negative
aplikasi nya kenapa ga bisa buka si	negative
yang k gb minnn	neutral
masa buka tuiter harus pakai vpn	neutral
kenapa dah ini tcokgtrgkrgx	negative
kak sudah dari sore ampe sekarang ga ada sinyal by u ada ganggu kah	negative
sblm waktu nya udh ga bisa internetan	negative
ngga suka main game	neutral
malam ini aplikasi by u gin terus kenapa ya tcocxvfcztn	negative
wah arti lola banget ya	negative
ga ada sinyal woyy	negative
apakah bisa beli perdana by u di grapari atau konter pulsa	neutral
asa banyak hp yg sudah band tapi kenapa cuma yg disebutin	neutral
min nomer saya yang aktif bawa di hp yang hilang kira kira bisa proses tidak ya thanks	neutral
kuota saya ga masuk masuk mana lgi lgi ulang lgi	neutral
bawa keluar paskal malah lup lep sinyal	negative
wes ilang aji ne	negative
kok pilih paket internet nya sedikit min	negative
min kok pulsa potong padahal g ada pakai	negative
g yang rb ini juga sudah cukup stabil juga	positive
jaring nya lagi kenapa yaa	negative
min aku dpt notif happy bulan kok tidak ada hadiah masuk ya di aplikasi	neutral
ga usah muluk jaring g anda tuh benerin	negative
iya tak pakai cm buat standby aja nomor	neutral
hai min aku kok gaada sinyal sudah hampir jam knp ya ini apa emang lagi ganggu di wilayah cilegon banten	negative
sudah ga pernah dapet lagi sekarang	neutral
aplikasi kenapa gabisa buka mau beli kuota	negative
min help kok mau beli pulsa bayar pakai ovo gagal terus ya dari kemaren	negative
sinyal tiap abis maghrib jadi tidak stabil kenapa ya	negative
sudah hari mo ngecek quota kaga bisa tcoqjtmqzdhm	negative
sinyal ya benerin min masa cuma dapat h	negative
mau bikin akun kok bgini trs min ud x nih tcoyowhvc	negative
ini masuk daftar nya	neutral
biasa jaring by u lancar aja sih	positive
	
min bkin fitur buat milih paket yg sudah beli donk	neutral
punya aku juga gin min mau cek kuota masih berapa karna lelet banget akhir akhir ini tcoaabmcc	negative
justru balik saya liat promonya engage banget	positive
min ngapain	neutral
ada options lain selain beli kuota di aplikasi	neutral
inti jangan pakai byu aja	negative
ken unlimited kuota dari byu sayang	neutral
min mending isiin aku pulsa	neutral
aplikasi by u di hp ga bisa buka	negative
unlimited naik speed tidak pakai promoan	neutral
kak ini kuota masih kog g bisa buat buka aplikasi by u dan instagram ya detail nomor sudah saya sampai tcovwsryriy	negative
pakai by u buat game ping nya kok tinggi	negative
woy ini sampai kapan ngeselin banget nih provider nyesel saya beli nih provider sumpah tcoesaqfhdpoa	negative
wk jangan pernah main game pakai by u gapernah stabil	negative
euro fantasy masih laku min liga daftar hadiah di byu space sama twitter kok ilang	neutral
kapan byu bisa bagi pulsa nih amp	neutral
ini emang gk bs connect netflix ya tcovmibnp	negative
sudah berapa hari tidak bisa buka appnya	negative
ya jangan karena sinyal jelek terus situ nyari bini mas	negative
g telkomsel byu lokasi tempat tinggal pun sering ilang	negative
min jaring lagi ganggu ya	negative
ya emang jarang tapi masih ada aja sms nya padahal dulu awal gagitu	neutral
loh baru tau by u ada youtubenya juga	neutral
bisa beli pulsa langsung lalu internt banking mobile banking ga	neutral
boro boro nonton konser online min	negative
g apa di tempat saya g saja masih kedip sering tidak konek	negative
kenapa saya daritadi begitu doang gabisa masuk padahal pgn beli kouta buat kuliaaahhhh tcowelffhcd	negative
pakai by u lah saya kira sudah kaya masa artezz beken mas beli kuota ribu	positive
buat esim lah biar makin banyak hape yg support esim masuk ke indo	neutral
min lapor masalah nomor kapan dong ditindaklanjuti sudah hari malam nih	negative
aplikasi by u ios lagi error apa ya dari tadi mau beli paket buka ke close lagi sumpah sudah restart hp	negative
sinyal aku diumpetin mana min	negative
wk sama nyata ntah lah ini eror bug tidak pernah ilang selalu ada	negative
jadi cerita kapan bikin paket aman p atau p	neutral
jaring by u akhir ini lelet	negative
alhamdulillah pakai by u ngga ada ginii terimakasih	positive
kenapa sih tidak bisa buka aplikasi dari kemaren mau isi paket nih tcopjfwjlky	negative
diam diam kan kok makin hari makin jelek aja signalnya ini	negative
kalau udh punya kartu byu apakah nnti ganti kartu juga ya yg dukung g	neutral
sisa kuota tinggal hitung hari bye bye balik lagi ke simpati	negative
padahal bar sinyal banyak loh	negative
jamin sinyal tidak ilang ilangan kayak gebetan enzy kalo pakai by u	positive
ini aplikasi selalu gin apa aplikasi terlalu berat ya mohon depan baik karena saya sudaj cuinta sama by u tcofovnvoapv	negative
pantesan lot bgtttt	negative
masih setia sama byu aman jaya sudah	positive
ini jaring internet kenapa ya kok ilang terus sudah di restart jaring tetep aja	negative
minnn jaringn kokk gabisa	negative
kenapa ya gabisa ngecek app bayu buat main mobile legends juga kadang gabisa login	negative
kenapa topping game sinyal lot ya min	negative
kenapa lot banget kamu	negative
bisa tolongin setting hotspot di iphone min	neutral
kalau mau beli simcard baru dengan paket data	neutral
maaf ya paket tri belum ada yg nandingin	negative
baiyu itu platform ajar kah tapi kok bagi bagi kuota ap ini provider baru ya	neutral
kk ini kalau mau nambah masa aktif gmn ya tcolbbengvqg	neutral
min abis beli kartu by u	neutral
kaya netflix blokir sama byu deh ku juga buka ga bisa pakai lancar	negative
kartu saya tidak bisa laku login	negative
aplikasi mu tidak bisa buka cok jancok dari kemaren	negative
awal keluar by u bagus banget sekarang ampas benar	negative
oya sihh yg mbps dulu buat socmed an juga lancar tapi buat download lama bahkan buat upgra tcojngfzzp	negative
website by u tidak bisa buka knapa min	negative
tapi kata kata dari byu ga salah bang di situ tulis aman jaya yang arti langgan ga khawatir tentang kuota	positive
tolong jaring yahhh yaamplop ga cocok banget kalo lg uji via zoom suara putus	negative
haduh ganggu babi lagi maen game yeuh ah kampret	negative
aku makek by u selalu beli paket unlimited biar bisa puas vc sama doi kalo kangen	positive
by u baik banget deh	positive
skrg masih belum bisa nih	negative
adminnya nctzen yaaa hayoloooo hayooooo gabaik tau kalo kita ga mutualan	neutral
laaa tau gakk w beli topping tapi kgk potong topping kena kuota utama sudah komplen kata dns sama vpn aktif padahal kagak nyalain tuh duaa pusinkkkk	negative
halo admin saya beli pulsa jam kenapa sampai skrg pula blm masuk yaa tcokxepcoy	negative
knp sinyal sini jelek bngt sering g	negative
min tanya dong kalo sudah pernah beli promo ini bakal bisa beli promo lagi tidak	neutral
benerin dulu jaringanya	negative
beli kuota gb hari rb ajah speed kayak keong apa baik lah sama kayak induk tsel sekarang kecewa tarif kuota internet paling mahal jaring edan eling lot kalo malam musingkeun lah	negative
mau sungkem dulu sama tcohzswhuwrmg	positive
bebas dari lot jaring g by u padahal bukan paket mbps	positive
apakah bisa says ganti email yg sudah taut ke nomor byu saya	neutral
mobile legends sama free fire min	neutral
sama nih app saya juga eror kaya gin persis padahal udh di update udh tunggu dari jam sampai kara tcopiwtbcjnf	negative
ini kenapa sinyal tiba tiba jadi h min padahal telkomsel g	negative
makin lama makin jelek nih pakai byu	negative
soal punya mu andro nyaa bagus aku ip mentok ios bah	neutral
kok aku gagal login terus ya bisa tolong bantu min tcouffhrzpl	negative
dapet coin tuh dari mana	neutral
minn kenapa tadi sekitar pukul wib sinyal by u ilang total yaa padahal mau dipake buat kuliah	negative
kenapa unlimited mbps by u sudah gk ada lagi	neutral
kak min yang baik hati dar saran next jika mau ada pelihara jaring kasih notif ke kita akan ada pelihara di tanggal sekian jam sekian sampai sekian agar dari kita bisa antisipasi kasihan yang lagi ngerjain tugas main game d	negative
dapet surprise dari terimakasih nindy kado tcogkmhkxse	positive
cees sinyal ilang iki	negative
min jaring di camat antapani kota bandung jaring ltenya kenapa ganggu h doang	negative
tentu sajaaa untung waktu itu make byu unlimited	positive
makin lot yg ulmitwd min	negative
btww bagusin dulu mint kualitas sinyal buat main game msh lag ga stabil	negative
awal kira juga gitu terus aku update msih aja gabisa	negative
tapi udha error dari abis maghrib	negative
kapan ada pkt g	neutral
makin lama sinyal makin jelek yah	negative
sekarang gausah belit belit kalian peduli sama langgan kalian atau tidak mau beri kompensasi atau tidak	negative
hai kak aku beli kartu by u di shoppe tapi lupa kasih catat email itu kartu ga bisa ada paket yaa	neutral
nindy tidak ngasih paket harga murah sih	negative
coba pke wifi kalau gk vpn	neutral
kak saya tidak bisa masuk ke aplikasi by u	negative
sinyal ampaaasssss sinyal gblllookkk apalagi pas ujan begini bikin eamosi sou tcomfrhuslhlw	negative
indihome di rumah saya lelet sekali jadi saya alih ke saja	positive
buset lot amat	negative
jaring by u tidak bisa akses pinterest	negative
kak cara ganti ke paket mbps biar aktif gimana yak tcopilriufpal	neutral
iyalo mau buka aplikasi by u gabisa juga mau isi quota habis sudah internetku dri semalem smpe sekarang	negative
ga ada sinyal sama sekali nih	negative
min ini mau beli paket internet lewat apps by u kok ga bisa masuk ke mode bayar ya	negative
aplikasi kenapa boss gabisa beli paket data ni	negative
kenapa sih buka yg lain cepet eh buka aplikasi sendiri lot cara liat sisa kuota tanpa aplikasi tuh gimana	negative
sudaahh sumpah ya ngeselin banget dari tadi jawab kayak gitu terus	negative
aplikasi saya tidak bisa buka info nomor telfon dan email sudah saya kirim di dm tolong di cek	negative
min kapan ada g	neutral
kentod sinyal benerin napah bapuk banget asu makin lama	negative
beli paket by u rb gadapet sinyal	negative
ini jaring byu makin parah dah	negative
thx quota monthiversary nya byu	positive
kenapa ini kuota sama pulsa saya tiba jadi semua padahal kuota amp	negative
gilani tenan bro go streaming pedot pedot	negative
ke bantu banget paket unlimited tapi jaring masih ga stabil tconsxoezli	negative
min kenapa kalo main game pakai by u ping	negative
wih kiraain saya doang yg kayak gin	negative
kirain mau give away	neutral
kok aku buka apk jadi salah terus sih dari pagi	negative
paket special pakai telor selalu andal dari awal pakai hup beta tcojjsaknt	positive
happy anniversary makasih ya kuota tcovvibutc	positive
ampe kagak bisa buka ini ya allahhh padahal mau belajarr tcojblemjl	negative
euro fantasy league by u space apa kabar min kalau ga lanjut biar saya pindah liga ajaa	neutral
ngga tau min maennya township doang	neutral
yang giga k ya min mantal banyak pis	neutral
aku dpt kadoo tcowbwqqhrg	neutral
paling enak sih bawa telkomsel juga soal doi	positive
gimmick aja ini mah segitunya caper	negative
saya juga sama loading terus lucu kalau akses pakai provider lain malah buka terus sekarang tidak bisa buka netflix juga	negative
min ini kenapa ya internet dah tidak bisa padahal masa laku masih tgl	negative
nyusahin deh aplikasi ga bisa buka padahal mau isi paket	negative
min aku gabisa lagi akses internet pakai by u padahal buat nelfon masih bisa	negative
masa iya harus ganti hp yg dukung g	neutral
gimana cara aktifin kartu min	neutral
tolongg dong ini pana g muluuu mauu drakoramm nihh	negative
aku ga lola sih kalau beli yg rb itu emang batas cepat ya cuma mastiin aja hehe	positive
ayo jdiin nct brand ambasador by u	neutral
lagi min hasil transaksi nih bayar gin manehhhhh by u ngapa sikkk tcoykixfdijk	negative
balik ning oredooo	negative
kartu by u ku saat ini tidak dapat akses atau buka lewat aplikasi nya bagaimana cara membukany sehing tcodncaspugij	negative
emang baru error ya harus pakai vpn dulu kalau mau akses ke app nya tcoqnaycgicji	negative
apknya kenapaa ini	negative
halo ini kok dari hari ga bisa buka aplikasi sudah bagai cara dilakuin mulai hapus cache trus u tcojsyttpwvci	negative
biar ga mikirin kuota pas lg streaming film tcojtgmdaqxv	positive
byu lagi down atau gimana kah tumben lag banget	negative
kok tiap ulang tahun saya tidak dapat hadiah kuota dari ya	neutral
beberapa hari aplikasi kok ga bisa buka ya	negative
suka lot ga tuh byu	negative
min lupa switch akun y	neutral
bulan mei tahun ini x dapet kado dari	positive
ehh sori btww nemu tweetnya lagi nyari byu masalah ngga heheh	negative
makasih loh hadiah nyaa tcovefyckbj	positive
kaaak jd by u ku aplikasi kaya gabisa akses akses gt	negative
yang ini aja belum beres masa akses alamat tentu kudu pakai vpn trus min tcorwxdeesvxe	neutral
kasih kado dong terimakasih kak nindy tcotcdyjuavl	positive
km ga ikhlas yaa	neutral
gk bisa beli paket nih min tconewbqpkr	negative
kuota aman jaya kuota aman jaya matalu soak ada angin langsung ilang g jauh lebih bagus mana mana hadeh	neutral
minnn aku butuh kuota	neutral
sinyal nya jadi bagus lagi tidak nih nindy	neutral
cuy buat buka netflix kok ga bisa	negative
asal tidak ada naik biaya	neutral
besok paket data habis	neutral
saya lagi on fire banget nih pakai by u hubung ps store ama steam lagi discount download nya jadi gila tota tcopuwusulo	positive
ini knp ya kalau buat buka spotify tulis tidak ada koneksi internet padahal ada kuota data nya	negative
jaring lagi buruk nih kaya pakai unlimited ga selancar dulu	negative
kenapa masih h jaring internetnya ini sudah jam berapa	negative
jaring baik dong kak	negative
kenapa by u gag bisa buka pinterest sih sedih kesel	negative
emg yang romantis cuma doang tcovibjveevq	positive
padahal tadi siang batas akhir kuota bulan	negative
iya ni signalnya juga jelek mulu	negative
jangan g g aja sukur	negative
min beli topping dari semalem kok belum masuk ya	negative
	
kuota yang bikin nempel sama twitter sih	neutral
kirain ada bi	neutral
kenapa jaring h	negative
halooo saya mau login di aplikasi kok ga bisa bisaa ya tcobghhlir	negative
bikin topping kaya gin dong masak kalah sama saudara sendiri tcogtnruxlp	neutral
gila yg gb hilang	negative
kok makin hari makin kecewa	negative
bebas dari lot jaring g by u padahal bukan paket	positive
saya rekomendasi untuk baik aplikasi	negative
byu apaansi sinyal hari ini caper banget	negative
sama padahal butuh banget data buat kirim dokumen gede	negative
min email byu bisa rubah dong min	neutral
min ini pulsa masih ada tapi buat sms aja kata tidak ada pulsa mohon bantuanny min tcojcaspbqdts	negative
alhamdulillah by u ada paket unlimited	positive
min gimana ni muter terus sudah beberapa hari jaring lot banget	negative
kirain solusi alfa indomart buka caba tcoieurxlrpke	neutral
kog sinyal ancur ya padahal sinyal telkomsel ga ada masalah	negative
dari kmrn suruh kasih data mulu begitu di kasih minta data lain kapan kasih solusi min sangat memgece tcotszppxxala	negative
dulu pernah pakai unli tapi mager streaming gk lancar jadi pakai gb p tconvhdkep	negative
makas ya by moga langgeng kita ya tcoazlbriyir	positive
tolong jelas kenapa hari ini sinyal ilang terus ini gua lagi banyak kerja oyyy	negative
duh pending banget yaaa pagi	negative
sudah mulai tidak stabil nih krn mau maintenance	negative
min aplikasi by u dari kemarin eror terus padahal mau beli paket ini gimana sudah clear cache	negative
akhir akhir ini by u bkin emosi	negative
yg mbps ribu moga lama ada	neutral
masih tunggu mbps datang lagi	neutral
ping jumping cokk cok	negative
minnnn masa aplikasi byu ku dari kemarin gabisa buka kenapa yaa paket ada sudah diupdate sinyal juga ada	negative
nah ini aku juga sering ngalamin kek gin	negative
kapan ada prime vidio	neutral
untung ku ada sinyal	positive
gk semua wilayah dapat band	neutral
biasa banget dah sinyal	negative
gua pakai by u udh lebih dari tcogtpijivmo	positive
sinyal e boskuuuu	negative
plis ini jaring gimana mau top up aja masak gabisa	negative
sinyal e banget nih dari tadi subuh	negative
kemaren aku ultah kok ga dapet	negative
ada yg pakai topping ggwp internet unlimited tidak pingnya aman kok saya pakai itu lag nya gada akhlak ya	negative
halooo ini jaring kok ilangan kok cuman h g ilaang mohon infoo	negative
ganti provider lagi dah ke belah	negative
pesbuk	negative
kouta gb yang kultum aja bom sampai nih	neutral
kelas malam dari emang mood banget dah	positive
wahh tapi kalo sini jaring tri malah parah banget	neutral
telkomsel sudah paling benar	neutral
kenapa nomer saya tidak bisa hubung	negative
ehh barusan coba kok bisa internetan ya min	neutral
sampai sekarang saya komplain tentang kuota topping yang tidak bisa pakai	negative
yang gb ituu	neutral
aku email tapi ga ada respon yg signifikan deh	negative
buka spotify aja ga bs tuh cem mana ya	negative
beli tiket konser itzy	neutral
aku dah ga pakai ini huhuuu	negative
sumpah iya banget masih bingung ini kalo aplikasi ga bisa di buka gimana mana dah mau habis	negative
kalo malam jaring ilang	negative
kalo malam selalu begini main ml paket unlimited tcombjdhhxlu	positive
ih kok bru nyadar baiyu warna ijooo	neutral
susah amat mau liat paket app nya ga bisa di buka masalah mulu tcoffncrkek	negative
pakai kuota unlimited dan sejak speed turun selalu pakai kuota gb	negative
sorry kalau oot paket gb k sampai kapan yah nin nyebelin banget paket monthly baru minggu juga tcoajsper	negative
mending ga usah sy sudah prnh dpt promo tsb tapi kecewa banget krn kita hrs punya kuota utama jd kl ga punya kuota utama ga bs jalan yt nya amp	negative
tidak bisa update tanggal lahir error mulu	negative
halo saya mau tanya apakah byu ada afiliasi dengan pt buana media teknologi	neutral
kak sudah hari ganggu kah jaring hilang terus dan tidak stabil	negative
sudah bung ganti jaring pakai wifi baru bisa	negative
abis upgrade ada bonus ga min	neutral
adeknya bagi g	neutral
halo min knp susah sekali login do aplikasi byu	negative
halo admin sy beli x paket qgb untuk hari kok tidak masuk ya	negative
kenapa kalau buka netflix gabisa tapi aplikasi lain lancar bukan aplikasi by u juga tidak bisa tcozfvwvklhk	negative
min bisa tidak yaa kalo mau stop paket internet atau bisa tidak yaa ganti paket yang sedang guna	neutral
lot woy	negative
yang pakai kabel buat buka nox game ragnarok mobile tidak kuat juga tidak kuat sering lag sedang buat login nox game ragnarok mobile saja kuat yang pakai kabel saja kalah	negative
mau tanya ada masa laku tidak ya misal kalau kuota internet saya ga isi nomor saya gimana	neutral
jangan sampai lewat diskon spesial sampai juta buat di tcozvkefcokyq biar makin jago bahasa inggris guys periode promo juni	positive
gimana kak masalah sudah selesai aku direspon gitu doang	negative
min pin ambil sim card kok belum rilis ya padahal sudah lebih jam sejak order no sim id mesan	negative
sama anjir padahal kouta tinggal mb bangke banget provider nya	negative
naikin speed unlimited	neutral
bebas ngegame game favorit saya sih salam gamers	positive
error lagi lu hadeh	negative
kak gimana cara ya ngehapus paket yang atas soal lot banget makasih tcokbxlwkhqz	negative
sudah d bntu ama ninin aplikasi kak	neutral
lokasi di palmerah jakbar tapi kok ya gin amat tcorbskzmis	negative
sudah hari bahkan nyaris hari sinyal gabisa dipake sama sekali	negative
ada masalah ape si lu kelahi aja kita	negative
cerita rem kuota by u habis	negative
tadi beli kartu bayu di outlet fajar cell sukamenak bayar lalu gopay	positive
bro kenapa lagi nih jaring	negative
kenapa sinyal jelek banget yaklo buat game	negative
min ini kl bisa gunain g harus ganti hp yg dukung g atau yg gabisa g gabisa pakai by u lg gtu min	negative
biasa deh kalau malam kumat mlu sinyal hadrh	negative
widih mantap nih bagai guna b yu dari beta tester wajib banget join ini mah	positive
min ini sampai kapan ya tcoumowmfln	neutral
kalo gaada sinyal kok bisa ngetweet cih	neutral
aplikasi lgi wda maintenance kah tcoxrrhmubffp	negative
min kuota promo yg rb gb hari masih ada kah	neutral
kenapasih bulan akhir sering banget sinyal tbtb ubah jd h bahkan g sudah gitu kadang meski g g tetep gabisa kepake	negative
min buka aplikasi kok susah banget ya	negative
lah troublemaker kok ngluh trouble	negative
aplikasi kok susah buka ya	negative
yang gb	neutral
dari kemaren jaring error mulu nih	negative
sama ni gabisa ngisi kuota	negative
minn ko kuota kemendikbud cuman bisa dipake buat wa	neutral
beli kuota di by u	negative
kok mahal kali gb bulan	negative
telkom kaya lagi ganggu do tadi saya di grapari rame bnyk yg komplen	negative
bisa ngundang mark sama temen nya	neutral
kirain cuma aku doang udh nyerah pakai by u mau ganti provider aja	negative
kenapa kamu hari ini rudet banget kuota sma jaring bagus tapi buka sosmed terus aja muterrrrrrr	negative
lagi main codm battle royal tinggal team tiba provider hilang ngeriiiii	negative
berapa saya stand sama gb nya ko nin	neutral
bikin topping kaya gin dong	neutral
min kalo beli kuota internet di aplikasi dapet formal e invoice nya ga sih selain dari e invoice yang di email format format pdf gitu biar enak kalo mau klaim ehehe	neutral
spesial kurma bisa buat tethering tidak min	neutral
tanpa minta kompensasi	negative
anak byu sudah siap emg sudah siap g sama dengan telkomsel	positive
pakai smartfren dong murah dan stabil	negative
hadiah e akeh iki	neutral
ada apa dengan aplikasi mu wahai	negative
kapan by u g	neutral
lagi musuh sama netflix apa gimana ya	negative
kenapa nih internet nya mati	negative
kenapa tiap buka aplikasi banyak something went wrong wait until reload page tapi ditungguin juga ga slese	negative
mau beli paket doang kok yo tidak bisa gimana to	negative
ini kok jaring dari kemaren malam h h terus ya asa beluk selalu g	negative
si by u ini lama lama ga worthy baru ngisi kuota gb tgl kemaren tiba tiba ini dah habis padahal ga d tcosrtvzuvg	negative
yg nyaman apalagi bawa internet kenceng nda nge lag	positive
salah	negative
cuan kenapa cepet banget abis nya ya min	neutral
maksud coba aja live on dari xl di tempat lancar soal murah juga	negative
tidak enak e pakete banding sama beli paket khusus wasap dn twiter tapi telkomsel tetep bisa me tcocaertpl	negative
yeu koneksi tidak stabil gimana mau main	negative
aplikasi lagi gabisa buka ya	negative
kak min bisa bantu stabil jaring internet sini g ya	negative
padahl lg enak ny nonton film min	negative
ga ada yang chat karena tiba tiba ga ada jaring ini kenapa ya min dari pagi sampai siang jaring ga connect terussss	negative
aplikasi kenapa selalu something wrong ya	negative
adminnn ini aplikasi by u emang error atau gimana ya mau buka by u dari sore sampai sekarang ga bisa terusss	negative
kenapa jaring jelek banget uda hari ini	negative
kira kira bakal dapet g ga min	neutral
yg stabil buat ngegame apa dong ka	neutral
towermu mati listrik bay	negative
begitu juga dengan sinyal mulai undlap undlup pakai tcopvlehgbg	negative
aplikasi saya tidak bisa buka info nomor telfon dan email sudah saya kirim di dm tolong di cek	negative
okee ih galau lah min baru ganti hp malah ga support g kan sjhdjsk	neutral
byu memang beda	positive
unlimited tapi skrg sering lot	negative
konter dekat rumah ane ada yg jual ngab	neutral
kak kok akhir akhir ini sinyal by u ga bagus ya terima kasih	negative
halo aku mau buka aplikasi byu tapi kok gabisa ya mau isi paket padahal	negative
tidak ada direspon kalo keluh mah hehehe	negative
lah ini gara gara by u toh sering keluar notif jaring offline ya	negative
sedia masih ada tidak	neutral
ini kenapa di tempat aku cuma bisa g padal biasa g mulu	negative
ababil yuuk nyalain kencang biar ga tinggal seru dkk di tcoriflz	positive
min kok akhir akhir ini saya susah login ke aplikasi	negative
dear aku kok mau beli paket data di apps ga bisa buka ya bisa di bantu tidak	negative
cok gae buka zoom ae di blokir	negative
kok aku gadapet sii	neutral
ada apa ini kaka ko tida bisa buka aplikasi by u	negative
team ga dapet bonus kuota ulang tahun	negative
cs baik	positive
min saya kan baru transaksi quota unlimited	neutral
eror kah gabisa buat whatsapp tapi buat laen lancar	negative
ini gimana udh coba install ulang malah g bisa login pakai jaring sendiri	negative
ini kartu perlu dituker kah min	neutral
happy monthiversary	positive
emang mantap pakai main game jadi makin tantang tcozqmdsea	negative
adain toping vision sama langgan	neutral
kok sinyal jelek banget dah	negative
harga paket bakal brp kali lipatnyaa yaaa	neutral
wah benar bangget kak gua juga sudah nyoba baru minggu langsung kapok balik lag tcozyqojbl	negative
kenapa sim kartu hape sya baca hanya panggil darurat	negative
cara nin	neutral
iya sama aku udh uninstall beberapa kali masih gabisa	negative
nindy emang oaling ngertii	positive
tapi kalau buka sosmed lain lancar	negative
min lama lama w liatin jaring by u makin ancur ya sinyal	negative
jelek banget sekarang sudah beli kuota yang gb sama aja hasil tcofvpidtxdf	negative
min by u lagi eror kah	negative
byu pantek sinyal gajls	negative
iya ya tadi sore kirain saya aja saya di katapang sekitar jam an sinyal tiba ilang walau sebentar sih jam gitu mungkin tower bts nya mati lampu hehehe	negative
aku ultah kok tidak dapet	negative
heu reng sih byu jeung kana pc mah	negative
di kasih kado sama tcoxrosfydk	negative
sinyal mu ampas	negative
nyampe sini adminnya	neutral
tidak g tidak masalah asal g sinyal bagus dan tidak sering drop	neutral
habis mo nntn anak gemas jenoo kok lemott batt	negative
min kok sinyal jelek banget toloooooooooooonk	negative
min kok paket gb rb ga ada	neutral
lagi eror kah gabisa buat buka netflix sm webtoon buka aplikasi byu juga gabisa tcoxgxswjeic	negative
bun ini kenapa ya bun kuota mo abis wei nanti tiba pulsa potong tcolqeszyle	negative
ada apa dengan aplikasi ya heng terus di iphone dan ipad	negative
kenapa gin terus ya aplikasi	negative
kok lot	negative
	
sinyal di bekas ilang nih	negative
g masih nut nutan wilayah ciganjur jaksel min	negative
ayok jujur pasti kamu sijeuni trus join markcity	neutral
ios benar benar masih error ya ini hambat banget mau beli paket internet i m leaving you	negative
asik banget bangun tidur dpt kado ultah dri byu	positive
appsnya rusak min	negative
baik banget makasih tcodyhxwltc	positive
demi apa si kalian dua sudah error minggu ada masalah apa cerita sini	negative
aplikasi u dari siang gabisa buka nie	negative
woyyyyy ganggu ini kenapaaaaaaa anjir lah sudah lot sering ganggu pula	negative
moga telah jaring kembali baik ya rindu internet lancar	neutral
bisa buat pakai apa aja kok kecuali media sosial twitter ig fb tiktok snackvid sama main game mlaov dll ga bisa juga	negative
naikin speed unlimited nya min sudah jaman g masih ada aja yang	neutral
min gamau beliin aku hp baru apa	neutral
dapat hadiah st anniversary dari	positive
nindy tolong yang awet yaa thr nya yang ini kuota masih banyak ini kalo beli	positive
aplikasi kenopo wooooy	negative
bagi kuota gratis dong min hehehe	neutral
paket ribu gb sudah tidak ada min	neutral
sudah hari ini kenapa sinyal kalian drop banget ya jadi h aneh kalo sudah masuk ke instagra tcoqxbqxmk	negative
dulu bagus deh tapi kok makin kesini kualitas turun sih	negative
min ini knpa ya kalau kan udh ada nmr ambil buat kartu tapi ga bisa di ambil kata ga ada padahal biasa hari	negative
masih nunggu wildrift masuk di topping ggwp	neutral
happy st anniversary buat kartu	positive
unlimited naik speed tidak pakai promoan harga sesuai oke ping dibenerin sudah gitu doang	neutral
di iphone emang crashed mulu appnya ya ini saya mau topup gimana nih sudah dari hari jumat loh gabisa buka nih wey	negative
banyak gb min ya ampunn cuma by u yg bisa dipake lancar di daerah	positive
jangan nyendat dong lagi streaming konser nih	negative
topping by u yang disney hotstar masih langgan psst masukin yang paket	neutral
bulan februari kemarin kenapa aku ga dapet min	neutral
saya beli nomor serta kuota ribu sampai skr blom di kirim	negative
area sanur dps malam ini polll lemott	negative
udh bisa blm kak aku juga gabisa akses tele dari kamis skrg gabisa login juga	negative
kenapa kok sinyal bagus tapi lot banget ya	negative
mls dahh mo ganti provider ajaa	negative
by u siap hapeku belum siap	neutral
kak jaring by u saya kok jelek ya kak ini dari kemarin lokasi di balikpapan kak	negative
besok tanggal merah	neutral
baru bisa nihh gonta ganti mode pesawat truss	negative
makin jauh karna meski sultan tpi by u masih jelek buat nemenin dia main game	negative
genshin masukin dong min	neutral
tadi dapet nomer bagus banget dam udh apal	positive
dm sdh bnyk kalian suruh tunggu terus	negative
tolong lah koneksi internetnya bikin stabil tiap hari ga pernah stabil	negative
lhooo yg penting kan telkomsel	positive
byu jadi lelet bangett	negative
gmana ini kok app nya gabisa buka mo beli kuota nih	negative
parah nih jaring dari tadi pagi	negative
coba bet kredit score anjlok sampai gegara sinyal putus kali tengah match	negative
min saya udh transfer tapi kuota tidak masuk gimana nih	negative
ah gajelas banget	negative
min by u di jogja kok tbtb jaring nya jelek banget beli topping tiktok ama ig lot banget	negative
adminnya antara markcity nctzen	neutral
pulsa sering kurang sendiri	negative
aneh banget ini pakai kartu gapermah ditunjukin bahkan beli paket lewat atm kok bisa dapat sms spam apa bocor	negative
sedih bngt siapa yang make ko saya ya tcoqacmvcimv	negative
aku tau akan dapat lebih cepat karena by u	positive
kenapa kamu hari ini kl ada sesuatu bilang	negative
ini mantep tidak btw jaring	positive
saya juga sama loading terus lucu kalau akses pakai provider lain malah buka terus tcolicdbnsj	negative
buat apa g	negative
mohon bantu saya susah login apk by u login pakai no hp nya juga ga bisa tcoegqykgsv	negative
sama nih kalo pakai byu ga bsa buka tokped dan bbrp web lain kayak trello microsoft teams dll	negative
sudah respon terus dari tadi kok gil tapi solusi ga bantu samsek	negative
demi allah nyebelin banget fak	negative
lupa switch acc ya	neutral
min ko app ku ky gin dari hari yg lalu siyyy sudah di install ulang juga tidak ngaruh tcogcmsjawiq	negative
isi batere dulu ampe	neutral
pls responsifff kakak	negative
jgn kek tai	negative
g doang	neutral
halo nindy sinyal ilang nih	negative
nyari sinyal lah internet by u kan busuk	negative
kak ada apa dengan sinyal by u ya e terus nih sinyal ada ganggu kah mohon info kak	negative
byu lagi ganggu ya sinyal ada tapi internet kok ga bisa ini saya sampai pindah sementara ke opsel lain	negative
aplikasi kalau crash ga mau buka mau beli paket data gimana	negative
koneksi byu	negative
ko saya gapernah dapetsi	neutral
puntennnnn ini app byu sudah dari jumat abis update apps malah kagak bisa buka di ios mau beli kuota ya b tcovukwspr	negative
gb sebulaan	neutral
aku tidak sendiri nyata	negative
jdi dia kya ngegabungin kuat sinyal dri dua perangkat yg beda gt	neutral
tak kirain punya ku tok mas	negative
koneksi internet and minggu ini parah banget knapa ya gk cuma hp saya aja loh	negative
percuma kuota murah tapi lelet	negative
bentaaaar harus lurus nih min kalo kita download update in game keitung topping apa quota ut tcostlchomq	neutral
mau login susah benar hadeuh ampun dah tcodjizqeypf	negative
keheul pis nya suka tiba tiba ngilang	negative
apa kalian musuh tiap pakai by u gabisa buka tokopedia tcofkthydhor	negative
kak saya ga bisa aktivasi sim card nya gimana ini posisi kartu baru	negative
tambahinn paket dong min	neutral
sering banget ni kaya gin masa harus restart tiap mau buka byu tcodxpdvphz	negative
pernah tapi gabut bgtt	neutral
min kalo nambah nomer di aplikasi ga bisa ya	neutral
hilang tanpa kabar	negative
tnks gann otw pindah di byu yang bln unlimited k itu bisa hemat xlipat	positive
momen ketika gua download puluh giga tapi tidak putus	positive
jaring di daerah taman tekno bsd jelek banget ya byu ada apa ya	negative
mohon info unk jaring wilayah surabaya lagi ganggu kok sinyal no service trims	negative
sinyal makin kesini makin ga stabil aja neeh	negative
misi min internet byu kenapa tidak bisa buat buka spotify yang benar aja min	negative
pakai fitur atur kuota mau bisa kok harga kaya awal	neutral
akhir ngerasain sinyal e pas samsung ngeluarin galaxy young	negative
sinyal nya dong tolong benerin hadehhhh	negative
aneh banget tbtb ilang jaring	negative
min kok saya gabisa liat transaksi di aplikasi by u yaa tolong check dm terima kasih	negative
sinyal saya udh ada biarpun dikit tapi tidak ada jaring	negative
min tolong dong kualitas sinyal nya bagusin lagi saya beli toping viu anjrit gabisa trs dipake nonton percum tcokgschuvwkn	negative
ini by u tu tiap hari error ya gagal terus mau login doang mau beli paket lg masa tiap kuota abis mau tcoxbwwbgmk	negative
kapan ada kuota netflix ni	neutral
min ini gmn mau beli paket gabisa lewat app lewat web malah bolak balik ke profil	negative
by u tidak bisa akses aplikasi line ya	negative
anda kenapa	negative
nindyyyy lot banget	neutral
beli paket ggwp baru jam sudah ga bisa buat login lagi	negative
wkwkwk ngapo harus byu sih	negative
demi apa dapat promo kuota banyak ini cuman k aja wk mantul banget sih tcowydyqw	positive
ni hp saye yang error ke byu makin tak betul ni tcokyoukl	negative
emang nindy yang paling ngerti tcoivkxgwgbxv	positive
sinyal harus bagus min sudah gitu aja	negative
min kok hapus postingan fantasy euronya	negative
jaring internet kok g terus ya lambat	negative
kenapa app nya di ios gamau buka si	negative
min bisa tidak hapus yg mbps biar bisa pakai yg mbps sayang beli tapi tidak kepake tcohudfrsd	neutral
tpi kalau yg make orang di keluarga jga cepat lumayan bikin geleng mas	negative
toping sms ke semua operator	neutral
kak saya mau daftar m banking kok gabisa ya gagal terus sms nya	negative
min kenapa app byu tidak bisa buka aku mau cek kuota	negative
tolong paket unlimited tingkat kan kekuatanya ke bos	negative
kalau aku bonus ga kepake karena make paket	neutral
by u keren sen kemaren lgsung sampai simcardnya mudah sinyal nya bagus yaaa di tempat saya tconptxlklrl	positive
call of duty knp gk masuk list	neutral
pingin make by u buat paket tapi by u sekarang lebih parah speednya ketimbang	negative
wkwk kalah sama kartu as	negative
halo min kalo kuota kemendikbud untuk bulan juni apa akan ada lagi	neutral
kok error ya	negative
email yg pakai daftar di aplikasi by u kak	neutral
emang tau mark itu siapa min	neutral
cara unreg kartu bagaimana	neutral
sudah cape diresponnya gin mulu paling suruh airplane mode ganti g apn melulu ada solusi lain ga	negative
makasih kado sekaligus thr nya tcoprpkxdie	positive
ini alas pindah dari by u ke provider lain buat sosmed lancar buat game pingnya stuck	negative
benerin aplikasi lu woy	negative
kak paket gb harga rb kembali dong	neutral
justin bieber sama superjunior akhir bisa pakai instagram musik tanpa vpn	positive
yahhh apa apa coba abis di protes baru muncul	negative
hp masih mahal kalo ada yg juta gass lah	neutral
lagi kenapa si min asa jaring susah mulu dari kemaren kemaren	negative
lagi pelihara app	negative
yap tadi siang ga ada sama sekali	negative
byu kenape sih	negative
tahan ya ka	positive
masih trouble tidak coba cek koneksi nya byu kalo maintenance pasti malam soal	negative
bln akhir mang gt ud kyk ilang kuota saya tidak pk dari tgl may tiba kuota saya dari tcovetuzkna	negative
buat apa ada kuota topping kalo yang dipake kuota utama	negative
kok aplikasi tidak bisa buka ya	negative
kirain cuma punya saya nyata semua user eror toh	negative
up adain lagi paket yang bikin aman mbps harga naek jadi k boljug juga	positive
makasih kado ultahnya tcoxltfgpzh	positive
jam hampir achievement masalah internet adalah kendala utama main apex tcodmgtckcp	negative
min banyal banget eror udh dm bilang bru ada salah tapi sudah bulan gin buka netflix	negative
genshin impact tidak sebut	neutral
heeh e mbak udh tak install ulang tetap saja tidak bisa	negative
kalo telkomsel udh g arti by u udh g juga	neutral
by u lg down yaaa	negative
sinyal nya ada tapi gabisa internetan bukan sihh	negative
parah benar dah zoom ga bisa spotify ga bisa pakai vpn baru bisa paket abal abal	negative
ini sistem app byu lagi error apa gimana ya soal suruh istirahat main hp padahal urgent banget beli kuota	negative
haloo by u sinyal kok jelek sekali yaa hari ini paket mahal mahal mau buka twitter atau web aja masak kudu tetering	negative
kenapa beli kuota dri pulsa sekarang harus pakai otp	neutral
coba aja siapa tau signal telkomsel nya udh bagus lagi	positive
aplikasi saya tidak bisa buka info nomor telfon dan email sudah saya kirim di dm tolong di cek	negative
sya udh tahun pke by u tapi ga dapet kuota anniversary	negative
iya nih kalo main game sering lag tidak bisa stabil saya lokasi magetan	negative
aku dipake twitter gabisa	negative
tau kalo sinyal byu di rumah saya sekaranh kenceng banget jd download atau streaming drakor ga bakal megap	positive
pindah ke aja usep	positive
kenapa ini apk nya ga bisa di buka dari kemaren	negative
mimin saya mau tanya dong bisa stop paket unlimited kita ga sih min makasihhhh	neutral
kirain punya ane aja yg gin nyata banyak	negative
kenapa saya isi pulsa daritadi jam	negative
macem macem sih salah satu ya nonton yt dan download game pc	negative
benerin jaring lu deh serius	negative
saya sudah punya kartu by u apakah saya boleh aju kartu by u lagi karena nomor yg lama saya guna untuk usaha bisnis	neutral
sinyal nya jelek banget buset	negative
tambahin dong min jangan mbps	neutral
panjang lagi dong min	neutral
sore paket tlpon saya belum masuk	negative
harga naik cepat naik tapi sama aja pas dipake	negative
tolong dong dari pihak by u saya udh beli paket tinggal jemput kartu d konter yg tunjuk tapi kata stok kartu habis udh hari janji tapi kata kartu tidak ada stok terus ubah lokasi ambil kartu pun gabisa tolong solusi yaa	negative
ek ganti provider nyaah kuota di pakai kalah musingkn anying ah tcourwdqdzky	neutral
miin tolooong gimana ini tiba tiba jaring by u hp saya ilang terus x sudah dimatiin di mode pesawat dll tetep gabisa ga muncul	negative
kog ngga bisa liat masa aktif sisa kuota kak	negative
sekarang jadi agak lelet di daerah jetis bantul	negative
min by u dpt g juga tidak apa cuma telkomsela aj	negative
kartu mba nindy	neutral
jaring tidak kuat	negative
jaring kok hilang	negative
asik sudah bisa terimakasih	positive
halooooo mimin nindy kok begniii terusssss yaaaaaaaaaa tcoolndksxpa	negative
bikin access point name baru aja bro	neutral
by u sinyal g tapi internet mati	negative
di magelang lte masih rasa g	negative
min bisa ga nomor telkomsel jadi by u haha	neutral
apakah harus beli simcard baru lagi kalo by u upgrade ke g	neutral
masih tunggu wild rift	neutral
halo ini kok dari hari ga bisa buka aplikasi sudah bagai cara dilakuin mulai hapus cache trus sudah hapus aplikasi download lagi ini kok masih ya nek kek gin lama lama pakai byu kok gin ya mulai streaming p tiba sinyal e pas buka	negative
jaring busuk	negative
kenapa sinyal dari kemarin h trus di daerah mekarbakti kadungora garut	negative
saat mati lampu dan tidak hujan	neutral
jgn beli yg unlimited karena batas	negative
yang unlimited ga ada thr min jadi rb windu eh	neutral
masa sering kaya gin	negative
paket unlimtd bikin aman jam dah tidak ada ya tcojdqsjtlyl	neutral
ini kenapa min sedih paket sudah mau abis mau panjang gimana sudah minggu ini kayak dini sudah coba uninstall install lagi sama aja hp samsung a tcouipsivafg	negative
jelek amat koneksi jaring tengah kota tcocrxsxkyi	negative
kaya gimana putus nyambung ya harus reconnect mulu sama d	negative
aplikasi lg knp ya kok gabis bisa daritadi mau paket hmmmmm	negative
ga bisa diandelin banget sih kali ini	negative
apps nya kok tidak bisa di buka ya internet lancar	negative
min ini saya beli kuota gb	neutral
lebih murah ya tapi pikir gantung by u nya nu brrti	positive
min ga bisa buka terus	negative
ga tarik ga ada hadiah	negative
admin please cek dm lagi maintenance kah by u huhu	negative
halo kak kalo notifnya begini terus gmn ya saya udh sampai uninstall kali tcogrrodmwm	negative
sudah nonton pakai by u	positive
kalo sudah bayar terus bagaimana tahu kapan kartu sudah sampai di indomaret yg tuju	neutral
by u kerennn keceeeee	positive
punya masalah apa si sama kok akses internetnya ndak bisa padahal buka aplikasi lain bisa tcorgocukjbw	negative
buat instagram lancar	positive
	
kalau belum siap udara di indonesia jgn buka provider baru	negative
oh kenapa emang rewel ga kaya biasanyaa	negative
tumben hari ini lelet ya	negative
ping aman min	neutral
pindah xl wal biar di tanggepin	negative
emang ngertiin kamu yang suka streaming video	positive
punya ku juga gin nin ini gimana ya	negative
sinyal nya bapuk gimana nih lg urgent	negative
aplikasi yg di android lagi gk bisa buka ya	negative
topping by u yang disney hotstar masih langgan psst masukin yang paket bulan juga dong min	neutral
unlimited naik speed harga sesuai dah itu aja	neutral
kalau paket unlimited max cepat	neutral
kenapa buka netflix sama spotify tidak bisa tolong di reply	negative
sinyal tuh benerin dari semalem error mulu	negative
ping waktu maen game minn aduhai sekali	negative
ga terlalu rekomen si buat sekarang mah hehe	negative
kenapa jadi payah banget buat donlot torrent ya cepat mentok kbps begitu kartu ganti telkom tcowdklcati	negative
minggu sekali rutin banget netflixnya tidak bisa akses ini provider saya yg rusak apa gimana deh soal kl tcoxirywrova	negative
kirim via dm ya kak agar bantu cek dan data jaga untuk keluh komplain kait produk dan tcokxclzgwwiz	neutral
tolong bantu kendala saya beli kartu perdana tetapi tidak bisa di aktivasi	negative
by u terimakasih sudah kasih promo kuota gila saya baru saja beli kuota gb dengan harga ribu arti pergb cuma k rupiah makasih	positive
minnn ini knp internet topping buat tiktok gabisa di pakai	negative
harus install ulang lagi tcoeskqztckd	neutral
jaring kok eror terus sih anjnggg	negative
hp nya yg blm siap min	neutral
sorry jbjb download app di apkpure kmrn ngakalin gt krn di playstoee udh ga support tapi barusan bisa lg download di playstore sih	negative
halo min ini byu sudah gabisa dipake ada minggu	negative
sumpah iya banget ih aku dari hari kemarin mau beli kuota ga bisa mulu padahal jam ini sudah habis bingung banget aku dah tanya adminya tapi balesanya itu itu mulu aplikasi juga masih ga bisa di akses	negative
tadi beli pulsa lewat jenius tapi kok blm masuk juga ya apa tidak bisa tapi saldo sudah kurang	negative
aplikasi by u ganggu ya kok dari beberapa hari yg lalu mau cek kuota di aplikasi by u gagal terus loading tidak kelar kelar	negative
bang aja sudah jadi anak yang bisa dari satu aplikasi kalo kamu kapan	positive
ohh byu itu dah banyak yg rekomendasiin	positive
beli kuota by u buat nemenin sahur nanti	negative
min cek sinyal di bandung dong dekat alun alun sinyal cuma dapat h nih	negative
dari daftar transaksi ku mungkin lihat apa topping by u yang sudah pernah dicobain dan jadi favorit ku tcoaisewyoas	positive
download aplikasi dulu ya min	neutral
moga guna lama tidak di bedain sama yg baru hmm	neutral
sangat tidak saran untuk main game ya adek adek	negative
by u mang gaada obat	positive
kita satu sinyal nyata saya juga kek gtu make yg unlimited	negative
capek aku yu sm km tcoxrtwabpdx	negative
jam tapi dkrng udh g ada	neutral
sama nih aku juga masa internet byu suka bengong	negative
belakang sinyal kacau	negative
ah terimakasih tcozpkrergym	positive
jaring lot yg sedia telkomsel bagai induk	negative
bogor sudah masuk sinyal g gakk min	neutral
g hanya untuk jakarta dan sekitar	neutral
bulan pakai byu kaya aman aman aja cuman sekarang sekarang sering rto apalagi kalo di jam jam sibuk	negative
kasih ya min si mark	neutral
makanya itu buat chat susah semua susah hadehh rasa rugi beli paket mahal mahal nyata tidak guna	negative
min ini kenapa aplikasi gin terus gabisa dibukaa tolong sudah dari bulan lalu kaya gin te tcohwuuivdal	negative
gmn cr nya sudah ke youtube dpt gb gratis	neutral
paket nya gede kuota nya dan harga nya ga mahal kok	positive
min mau nanya dong by u sudah bisa e sim belum ya	neutral
min ini jaring byu burik banger dari pagi edge terus tidak bisa kerja	negative
permisi min mau tanya tentang aktivasi tcohwhlft x samsung	neutral
kok gada terang apa apa ya dari byu kek mgabarin gituu	negative
yg mbps bikin permanen dong	neutral
aku baru tau kamu punya musik yang senang ost transformers kalau bisa di masukin juga yaaa saranghae tcowtgllciii	positive
sayang ribu sayang tempat saya sinyal byu lot	negative
kenapa susah sekali buka aplikasi byu	negative
kok aplikasi nya ga bisaa buka sii	negative
emoji buat jaring yg tengah hari td hilang	negative
lagi gabisa beli paket ya	negative
min cara beli kuota gmn selain dri aplikasi soal lagi mt aplikasi by u	neutral
min kok nomor byu bisa tidak dapet sinyal g ya padahal di tempat yg sama nomor byu lain bisa dapet mohon bantu min	negative
min paket gb ampe kapan	neutral
rencana mau ganti kartu ke indosat	negative
kita butuh thr tanpa beli kuota	negative
by u kenpa sih tiap buka app lot banget kadang tidak bisa mau cek paket susah banget	negative
umum aplikasi by u error sejak update versi ke tidak bs buka	negative
pending bangeet	negative
aplikasi gabisa buka mulu kenapa nih	negative
kok kartu by u ku gabisa buat akses twitter dan pinterest tapi buat aplikasi lain masih bisa mohon bantu min	negative
mudah mudah baik jaring	negative
giga k	neutral
sudah saya kirim	negative
hampir gb sie kalau pakai normal hari gb	neutral
data aniversary ga ada lg ya	neutral
alhamdulillah masih	positive
baru sadar nyata spotify dan tokped emang dari kmrn juga gabisa website tokped kayak di blokir gitu sama kayak net tcoyrqrzxbbvm	negative
sudah ga asik unlimited pakai fup hijrah ke lagi ah	positive
nungguin rejeki nomplok dari by u	neutral
aplikasi kok sekarang sering gbs di akses sih servere tambah atau diupgrade lagi dong	negative
kuota byu yg k kok uda gaada sihhhhh sedih nihhh	neutral
jaring dibenerin dulu	negative
please ini kenapa ya min tiap buka aplikasi selalu begini sudah uninstall aplikasi tetep begini terus saya mau cek kuota dan beli paket data ga bisa tcolekzpcfjpm	negative
sedih banget td sore jaring byu ga stabil buat zoom	negative
tipsnya jangan pakai byu	negative
ni sinyal makin kesini kok makin sulit ya	negative
eh iya benar banget lagi thank you by u	positive
ada promo murah kah dih tgl ini	neutral
akhir dapat thr dari papa	positive
kok aku kemaren ultah gadapet kuota gratis min	negative
makanya pakai	positive
app kok ga bs dibukaaaa mau beli paket min	negative
sinyal kok ilang ilangan ya	negative
harap dapat kuota dari mimin karna tanggal besok ulang tahun	neutral
seperti emang kunci sudah pindah ganti modem pindahin ke hape semua sama aja langsung ngacir kalau di hape ato modem pakai nomer lain emang kampret ini byu komplen sama cs diputerin ga jelas solusi	negative
halo kenapa sinyal saya tiba tiba hilang dan tidak baca ya	negative
min ini kenapa ya telah up ga bisa buka appsnya tcoashzsgv	negative
haloo apa by u sedang eror kok saya kirim sma buat verifikasi mobile banking tidak kirim dari kemarin	negative
asiknyaa dapat kado	positive
benerin dulu deh aplikasi makin hari makin busuk	negative
woy bangsat balikin uang saya ngk bisa aktif kartu suruh tunggu sdh lebih jam	negative
sudah hari kenapa sinyal h terus min padahal aku pakai yg gb bln apa kualitas sinyal makin nurun	negative
makin hari makin gajelas sinyal nya	negative
app by u kenapa si tiap w buka error mulu	negative
sayang cuma ke sama by u padahal mantan pakek telkomsel	neutral
mbps yak jan harap dl lu kelar dit	neutral
hmmm sudah biasa rb gb	neutral
hape lah tinggal search google atau buka youtube	negative
maqn kesini maqn lot aja nih apalg kalo ujan	negative
halo by u kenapa signalnya mati terus ya	negative
ngk usah bnyk tingkah kalau jrngn msh nebeng	negative
min aku mau beli kartu by u tapi beliin ya	neutral
emang paling bisa pdkt nya ke kita kita	positive
isi pulsa ko blm masuk min dari malam	negative
di speed test doang bagus nya kalau akses website lain atau update aplikasi lot nya minta ampunm ada yg kek gitu tidak	negative
kenapa ga ada genshin impaaaaccccttttttttt	neutral
ha g tidak bro aku hanya ingin main ml tanpa ping naik turun	negative
moveon ke dong sist	positive
halo sy guna by u kenapa akses app by u susah sekali saya mau isi paket soal	negative
ini jaring di dramaga kenapa oy dari sore eror gin ilang ilangan kaya hayabusa	negative
kenapa lagi ini kok ga konek internet benar benar	negative
cara guna topping mola by u di aplikasi mola gimana	neutral
min parah aku baru tau ultah kemarin aku ga dapet kuota gratis deh	neutral
apk by u ku gabisa di akses malah	negative
admin kok gk bisa buka apk webtoon ya padahal pakai wifi lancar aja	negative
are u okay kok daerah lot banget padahal belum lancar	negative
kak aplikasi sering masalah nie	negative
internetnya dari kemaren lot banget kenapa deh	negative
untuk yang sekian kali saya masih kecewa dengan cepat internet yang saya dapat	negative
ini sudah diupdate tapi kenapa tidak bisa buka tcolxuqsdrlb	negative
kenapa nih ngga bisa buka app buat ngecek kuota tcogvlglulsp	negative
harga yg paket per mbps turunin itu ajah	neutral
kabar besokanya buru cek out huft	neutral
ebuset benerin ini dulu napa mint	negative
kouta saya yang belum masuk gimana nih udh hari lebih bom ada jelas dari by u jangan suruh tunggu terus dong sudah muak saya	negative
kenapa si kalau mo isi kuota krn habis dari smlm buka aplikasi pakai wifi gk bisa apa emang lg ganggu tcodanzunepx	negative
buat zoom kenapa tak bisa yes	negative
dari hari yang tiap hujan petir selalu turun mulu sinyal dan ga bisa internetan sama sekali selalu pakai tetring tetangga terus kenaoa ya yangguan mulu	negative
lagi asik download eh sinyal by u mendaduck lot horror banget ga sih	negative
gadapet rhr jadi ga beli apa apa	negative
halo kok di android byu gabisa login via nomor ya	negative
jaring iku lhoooo	negative
bikin emosi kan	negative
nindyyyyyy ini sinyal byu kok jelek ya padahal sudah set g mana bar penuh semua tapi main game malah tcotibhcyal	neutral
min mau nanya dong kalau kita beli paket unlimited mb yang rb kali apakah cepat akan lipat jadi mbps serius nanya	neutral
ada nih min jadi waktu main pubg ni min baru banget mau ngerush eh tiba tiba ping drop	negative
masih begitu tidak bang saya sampai sekarang masih tidak bisa buka	negative
cok koe saiki lot banget su	negative
ko aku pas ulang tahun ga dapet ini sih min	neutral
appan g ga terlalu harap buat w yg cuma idup di desa g aja bom sampai sini kog	negative
kalo saya make yg unlimited kadang kalo ga ada duit beli yg gb siii tapi kalo yg gb paling habis dlm minggu	neutral
hallo min ini sinyal g kenapa nih waduh saya lagi streaming tiba tiba no connections bagaimana padahal saya langgan paket unlimited ini	negative
tapi repot banget anjir tadi make hp temen dulu buat isi kuota	negative
kuota internet dong	neutral
udahhh bejo ne ni dah bs mas step kudu connect reconnect wifi trs	negative
ya baru tau sekarang unlimited bisa tetheringan uaa	positive
baik ini dulu lah era digital masak restart hp mau cek kuota tcoggvdfyxd	negative
hp masih mahal	neutral
netflix di blok aku buka pakai telkomsel bisa tuh	negative
lagi ganggu aku buat streaming kok gabisa	negative
thanks byu berkat paket unlimited byu saya untuk bulan gk takut lagi buat nonton youtube	positive
udahhh ini eror gr gr update app gamau masuk igil kesel banget asli	negative
kenapasih gabisa loading sama sekali lagi baik apa gimana	negative
kenape nih gabisa buka netflix sahabat	negative
maklum sesuai moto byu semua mau	negative
punya ku juga loh min tcovhhaenflk	negative
min kenapa ga bisa masuk aplikasi siih dari semalem	negative
dari tadi mau aktifin sim card tidak bisa gimana ini tcoqvsbdlitr	negative
kenapa sinyal mu timbul tenggelam deh dari tadi siang	negative
ya masa vpn terus	negative
baik banget dah hueeee tau aja lagi butuh jugaa makasii banyak banyak yaaaa tcodpyaohvz	positive
buka tiktok lancar tapi buka netflix	negative
min saya beli pulsa lewat aplikasi tadi siang sudah di transfer tapi belum masuk	negative
hari ini habis beli yang mbps hari skrg tiba gabisa nyambung internet duhhh	negative
di pas anniversary kasih kuota	negative
hahahha adminnya gabut yaaaaa	neutral
baik si responnya cepet	positive
smaa bgttt saya main game kalah mulu grgr tbtb jaring lot	negative
misi min cara ngecek nomor masih aktif atau tidak gimana ya	neutral
lagi download terus kuota abis tidak nyadar jadi nyedot pulsa untung by u tidak gitu ya jadi tidak perlu was was	negative
tri aja sudah	negative
nyata ada temennya gbsa juga	negative
yaps provider ini nama semua harga paket murce banget tcolpqfiljmj	positive
sinyal dong baik tiap buka aplikasi buat ngecek kuota dll ga bisa mulu padahal selalu pakai yg paling mahal k bulan buka aplikasi something went wrong mulu tiba sinyal ga ada tiap komplen suruh nyatet tgl waktu trouble dll	negative
pakai kartu belah	negative
mint kok kuota disney hotstar ku ga bisa kepake ya di aplikasi disney loading mulu tapi cek kuota di byu masih gb	negative
saya sedang proses pindah apakah bisa guna alamat yang lama	neutral
awas aja yee kalo lama terus sampai hari gabisa buat internetan	negative
knp y bayu pas awal bagus tapi lama lama jleg	negative
punya kamu masih eror kah wa nya skrg	negative
naikin speed unlimited gk banyak banyak yg kayak kemarin aja mbps	neutral
apalagi kalo ujan buset asa tinggal di hutan	negative
kok paket rb	neutral
aku beli sim rb udh dapet kuota gb makasih	positive
min kok unlimited	neutral
podcast yg bahas aplikasi busuk dan cs yg bisa cuman sok asik tapi tidak kasih solusi ada tidak ya	negative
friendster itu lupa lagi bentuk nya seperti apa dulu	neutral
sinyal jelek banget demi allah kesel aing	negative
makasih perhati banget cieee tcoqdvxstep	positive
tidak mau nyediain topping mola tv nih	neutral
apa lagi maintenance ya	negative
bagus lah ada variasi unlimited mbps tambah lagi variasi unlimitednya	positive
jangan suruh saya restart hp	negative
unlimited tapi kualitas speed byu akhir ini turun nih	negative
kenapa sinyal timbul tenggelammmmm	negative
kuota disney kok gabisa dipake ya padahal kuota utama sudah abis	neutral
percuma byu g bagus buat game online lag	negative
yg ribu	neutral
min kok di camat maleber kuningan jelek sinyal nya	negative
jaring byu lebih jelek dari si tiga	negative
gila sekali anda saya aja gb bisa minggu itu juga cuma rb pakai im	negative
min tadi sinyal by u ilang mana	negative
min knapa tiba tiba kartu by u saya hilang signal eror sudah jambegini terus padahal kartu kawan saya aman saja di area yg sama	negative
apa pat gua masih kek kontol ga disempakin ga jelas benar telkomsel ini kontol pepek jembut	negative
ini gimana sih makin lama makin ruwet	negative
tanya min apakah kartu by u bisa volte kaya simpati ashalo	neutral
baik ketika tanggal tua serang tcoolmvpeabl	positive
min kenapa dari kemaren seperti ini kalau bukak aplikasi tcoqifuxphlw	negative
makasih dapet kuota gratis tcopjszfqgu	positive
kenapa dari kemarin apps saya kek gin mulu ya tcornhokyi	negative
jaring g kalau maksimal juga mantap lagi g tapi kalau enggak rela buat korbanin kuota demi rasa speed g kes sayang	neutral
apakah byu lagi ganggu	negative
makasih kado tcomolzcisw	positive
lihat min ya walaupun sekarang udh tidak bisa main ml krn klau login selalu tidak kuat jaring nya	negative
ini kenapa eror terus sih pas mau masuk aplikasi	negative
harga paket murah banget	positive
akhir ini koq koneksu g bisa buat akses beberapa web ky pinterest spotfy dll y apa memang lg masalah y	negative
baik banget	positive
kenapa tiap buat aplikasi sering gin min sering banget lhoo ini	negative
nasib pas lagi tegang tawur tiba hubung kembali pas hubung tau dah tewas	negative
unlimited naik speed	neutral
tpi lot	negative
paket by u gb hari tidak bisa buat buka instagram	negative
tau ga sinyal lu buat game ampas banget	negative
kenapa aplikasi susah buka	negative
tau ndiri lah csnya bot	negative
paket thr spesial kurma gb murmer nya knp malah dihilangin sih	neutral
biasa bulan bisa gb lebih buat streaming anime sama download file	neutral
harus aku beli ipon supaya bisa g	neutral
lau juga problem	negative
dear admin hari ini sinyal nya ganggu kaum ldr untuk lepas kangen buaaanget	negative
aku kemarin tgl ultah tapi tidak dapet apa	negative
plis banget lagi kelas sampai harus ngungsi ke musholla biar dapet wifi tcojdxdjzem	negative
itu teknisi ngapain kok mlah ngecek dri luar kocak dh tpi sayang banget itu lngsng co angus dong sisa	negative
netflix disney mining trading steam online games udh ituuu aja circle hari gb saya	neutral
bang kok dari pagi ngada sinyal bang	negative
kalo ngga pakai vpn wifi ngga bisa buka	negative
kenapa hari ini jaring ganggu mulu di bandung min kadang malah tidak ada sinyal sama sekali	negative
ada yang pakai paket game by u buat game sama aja apa lebih bagus sih	neutral
ih ada bonus kece amat	positive
lumayan gocap dpt gb tcopabwmyuy	positive
cuma yang perhati	positive
lemott banget cuk	negative
gb ribu mewnghilang dari app mana	neutral
halooo min kok apknya tiap buka keluar terus yaaa	negative
yes kali yg mbps pas msh kenceng	positive
aplikasi by u gimana ini belum bisa masih crash mulu	negative
sinyal knpa jelek terus tolong aku lg sedih malah jd tambah sedih	negative
ko ane gadapet kuota ulang tahun ya min tcoojsvtzkcp	neutral
maaf jbjb mba wa saya juga gabisa mba	negative
cek dm min sinyal ngilang	negative
plis jaring benerin min download gb cepat cuman gin kuota masih gb tapi semua kek gk guna tcoaksplf	negative
agak maksa ya byun	negative
harus ganti kartu juga tidak min	neutral
deri kemarin tanya sudah di jawab trs di suruh kirim video pas masuk aplikasi kak tapi masih belum ada ubah trs aku tanya lagi tapi jawab juga itu mulu kesel ih padahal dulu ngga gin lo huhuhu	negative
apa karena ini min internet jadi lelet	negative
tidak ah jaring labil	negative
emang sinyal gin terus kah sudah hampir bulan gada ubah	negative
aku waktu itu ultah tidak dpt ya hadiah dari by u	negative
ini ganti unlimited	neutral
ngabuburit sama sinyal yang eror	negative
sering banget beberapa aplikasi susah buka dan harus restart hp dulu kenapa ya min mohon baik	negative
kenapa byu gabisa buka netflix	negative
kenapa jaring ga bisa untuk dengerin lagu di spotify	negative
kok jam gin belum sampai indomaret padahal sudah tgl kenapa min tcolzfqv	negative
jaring g nya kok lemah yah	negative
masih setia sama byu aman jaya sudah mbps	positive
min barusan uda x coba tapi gagal terus pas buat akun gimana ya	negative
ko aku ga di kasih	neutral
bisa tidak yang gb nya masa aktif bulan tcolxjlfpdz	neutral
topping ignya ko gbs dipake ninnn	negative
dear admin jaring di kelapa dua depok jelek masa	negative
ribet banget registrasi	negative
yang k gb buat hari	neutral
sudah hari ke loh ini masih g ada progress	negative
tapi tetep aja ya lelet sama konek ke server host apa makin lelet tapi noren parah s tcozgqyrjokg	negative
min kok yang gb ribu ilang	negative
iya ini dari pagi mau beli paket malah ga bisa buka mana gabisa pakai	negative
dengan jawab yg tetap standard tcoqxxpiqyga	negative
app knp sering ga bs di buka	negative
apakah paket g akan tetep mahal dan buat apa g kalau pket cuma max mbps	neutral
niat jadi provider ga sehh	negative
by u ilang sinyal ga ada kuota lagi selain ini tolongggg tcorksysrvfd	negative
jangan pakai jaring by u tips nya	negative
ini kenapa nonton youtube bukan kuota topping youtube yang habis min tcolxvcjvhrh	negative
gabisa nonton	negative
akuuuuu sedi banget tapi sekarang ga ada paket data yang jam ribu huhu padahal itu ngebantu banget	negative
padahal mau ranked	negative
pakai dong soal paket murah	positive
min mau tanya apa benar masa aktif kartu by u semur hidup asal dpat sinyal internet	neutral
saya ya ngikutin cara apn dari byu doang dah lancar bet kalo yg pure telkom tcovxrriyy	positive
aigoo apa tuh min jangan bikin jantung tali yak	neutral
ada nih gin terus dari tadi padahal ada sisa kuota bisa buat youtube browserchat tapi buat spotify pinterestgame kok tidak bisaaaaa tcodopiatckvm	negative
beli kuota alhasil g kpake sama sekali	negative
sudah tidak ada min jangan prank	neutral
tapi agak lelet sih di daerah kaltim tolong dong min tingkat lagi ya min jangkau cepat speed yg d tcoogpvxizav	negative
gmn nih drtd jaring h trs	negative
ini aplikasi apa gmna ya	negative
kenapa aku masih ada yg sms ga jelas tcolnxsrxotr	negative
tethering pala lu kotak lot cok	negative
beda emang kalo yg ini	negative
min tolong dong kualitas sinyal nya bagusin lagi saya beli toping viu anjrit gabisa trs dipake nonton percuma dong sinyal juga jelek banget sial	negative
ya allah samaaaa derita ip sama sekali ga bisa buka ni app udh mau hari	negative
sama nih saya juga ga bisa login padahal kuota sudah kepake sampai sekarang tcoggeboqhj	negative
min kartu saya ga ada sinyal sama sekali kenapa ya tcosmhumcjjg	negative
kok skrg sering gin ya applikasinya tiap mau ngecek kuota	negative
markcity kan min	neutral
jaring sekarang kok burik kali min	negative
knpa aplikasi saya tidak bisa di buka padahal internet lancar	negative
adain promo rb gb dong	neutral
masih undermaintenance ya dari semalem mau streaming susah banget	negative
dari pagi smpe sekarang jadi salah terus loh min kesel banget dah	negative
mending kalo ngirim chat mas ini buka aplikasi byu aja gabisa harus airplane mode dulu da tcoggbglysxr	negative
gimana ini saya sudah lanjur beli paket masa speed internet cuma gin	negative
gimana mau isi kuota kalo kaya gin terus tcowgczxrcsy	negative
ini baru rencana mau pesan nomor sama paket by u blom pke tapi app nya force close terus jadi belum bisa pe tcoollurdy	negative
jadiin paket permanen sabi kali	neutral
mon maap min serius mau nanya kan hubung di tempat kerja rumah udh pakai wifi jadi j tcozxamovr	neutral
ajg	negative
kaget banget tiba ada notif happy anniversary padahal yg asli masih september well then	positive
cara ngumpulinnya gimana ya min	neutral
min jaring saya dari kemarin ga bagus kenapa ya suka ilang koneksi padahal baru panjang paket intern tconihrzcgn	negative
bisa di pakai tidak buat aplikasi maxstream telkomsel min	neutral
jangan suka tiba tiba mati sendiri jaring dong bikin orang kesel aja	negative
ip ku ikut menang juga sampai sekarang masih ga bisa buka appnya	negative
baik dulu aplikasi mau beli kuota aja susah mnta ampun	negative
diucapin kasih kado sama temen	positive
iya nih saya nanya dri kemarin ga di jawab	negative
gk cuman jakarta ini sukabumi yg biasa sampai mb s kalo download sekarang kb s pun nggk parah emang	negative
jika sudah namun masih kendala	negative
anjrit gaada foto yg lain min yg cakep gitu	neutral
ngapanii jangan ngasi sinyal	neutral
sinyal full tapi kok lot banget ya	negative
kak saya mau ngaktifin nomer saya lagi kira kira bisa enggakk	neutral
min apknya lagi down ya	negative
kok g bs pke zoom	negative
ga bisa dapat sms otp dari by u	negative
ini sinyal nya kok ilang ya padahal sudah beli paket data nih	negative
potong data nya ga min kalo nonton	neutral
ni emang suka ngasih kejut deh	positive
min paket ini masa laku hari tcoaqwzzdsoos	neutral
kenapa sih dari kmren mau login aja susah banget	negative
apakah by u nanti stabil buat game	neutral
sama banget kadang buka twitter juga harus pakai vpn	negative
kak ini knp sinyal by u tiba ilang	negative
untuk speedtest aja tidak kuat min	negative
min ku beli pulsa via linkaja kok blum masuk min untuk keteranngan di dm	negative
tidak ada di daftar nih	negative
aplikasi saya tidak bisa buka info nomor telfon dan email sudah saya kirim di dm tolong di cek	negative
sinyal tlonglah toddd	negative
giga buat bulan murah tuh	positive
by u benerin sambung internet mu dong masa connect netflix spotify pinterest kudu banget di g	negative
kampret puguh beh	negative
malah naik td mow beli gb hari batal karna pulsa kurang ribu yaudah make belah lg manyan rb bulan	negative
buat ml pingnya aman ga nin	neutral
tapi ngiklan nya bisa buat tethering itu loh yg bikin kesel buat dipake sendiri aja sudah lot gimana buat hotspot	negative
sim card terang alamat tidak lengkap	negative
lama tahun mas aja lot	negative
sudah disett ini itu ttp aja sinyal jelek semua guna tsel ngerasain yg sama min	negative
tidak ada kuota	negative
kenapa netflix di blok min sudah standart loo harga paket data mu sekarang	negative
thr kuota nya mana nih min	neutral
fantasy w ubeg kgak nemu eh nyata nyata hapus xoxo	neutral
harus ada wifi soal kalo pakai by u lag parah	negative
ngga nyoba	neutral
coba di tingkat dan di stabil lagi jaring jgn bikin eneg	negative
min ini kenapa ya abis update gamau buka	negative
makasih sudah tahun loh kita ciee tcosaizhqxfn	positive
by u kenapasikk mau beli paket malah gin tolong dong min tcoqczvpjzmc	negative
makin sih makin parah dah	negative
wish lu baca sono dm komplain user itu wish orang hadap lu min	negative
kok lelet	negative
sama ih kemaren mau zoom pakai by u gabisa samsek blokir apa gimana	negative
sinyal ilaangg	negative
line wa dan aplikasi buat chat dijadiin aja jadi paket kek topping ggwp	neutral
aplikasi ga bisa di buka	negative
min promonya tiap hari apa aja min	neutral
ga bosa login ke app by u	negative
lu yang cek dm gua sudah gua kasih tau semua itu lu malah nyuruh saya isi survey nindy care apa itu sakit hati saya	negative
ada yg sama ga kalo jaring nya tiap malam lot apalagi kalo kasih ujan dikit jaring g rada parah	negative
tau anjir nyusahin banget saya dari kmrn jumat gabisa skrg kuota saya abis gabisa isi gabisa maketin	negative
lohh min	neutral
btw belum itu harga rb tapi cuma mbps sudah makin murah sekarang	positive
pakai by u ping pubg merah euy sampai ms	negative
kak cek dm ya aku sudah berapa hari no service di hp	negative
sinyal by u paling stabil	positive
harus ganti hp lagi	neutral
lot banget lama	negative
min bisa ngga ya telah beli disney lewat byu dan nontonnya pakai wifi	neutral
pakst gua yg rb gb mana	neutral
min kindly check ur connection buat yutub lancar sejahtera tpi gilir dipake maen dan download sering suka putus thank you	negative
akhir akhir ini tiap buka app selalu loading bahkan pernah tidur bangun masih sama kira kira kenapa ya mungkin guna yg lain alami juga tcofwajozhw	negative
btww bagusin dulu mint kualitas sinyal	negative
kak beneran jangan kaya dinegri wakanda yah warga net dibohongin mulu abis beli ga sesuai dengan realita	negative
	
min aplikasi by u saya gabisa di buka	negative
buka appsnya kenapa something went wrong mulu ya	negative
kenapa mulai kecewa sik sinyal rumah sendiri yg biasa penuh kenceng skrg cm bar dan speednya ancur banget kalo keluar rumah baru lancar udh ngadu ke cs solusi ga ada yg works tolonglaaaaaaa	negative
pagi min hari ini aku beli pulsa di m banking udh hasil tapi ga masuk masuk	negative
kompak sekali nihhhh pada ilang koneksi internetnya gimana nih	negative
wah gila telkom apa kalo bole tau bang	positive
telah tengah tahun minta terus diadain lagi paket mbps k	neutral
males banget sudah ngadu di ig trus cek bilang gaada kuota tcotmbcmhrs	negative
loh kuota baru	neutral
min sedia toping molatv juga dong mau euro nih	neutral
eungap anjir make telkomsel	negative
yuk by u bisa yuk kalo pelihara sistem jangan bikin down sinyal kan kartu milenial	negative
buka app aja bgitu terus pantes koneksi ga stabil tcohakcgdsedb	negative
aplikasi saya tidak bisa buka info nomor telfon dan email sudah saya kirim di dm tolong di cek	negative
rekor lama kamu hilang sinyal berapa jam	negative
koneksi kenapa tiap malm	negative
aplikasi saya tidak bisa buka info nomor telfon dan email sudah saya kirim di dm tolong di cek	negative
gimana ni kok mati semua	negative
lag banget anjir by u sekarang	negative
ko sinyal nya tiba ilang ya ada apa ya sy g bisa kerja ni kl g da sinyal tcoqefqknesjv	negative
saya pakai nya sih rada aneh emang	negative
ini kenapa buka app nya error ya ke close mulu	negative
cek dem plis urgent beli paket gmasuk tapi uang udh potong	negative
segitu nyebelinnya by u makin lama kualitas internetnya makin buruk tcodhfklebgjb	negative
halo min ini apk nya error ya dari tadi kok bisa buka sudah uninstall juga masih aja g bisa	negative
min apakah gratis nelp hanya bisa pakai ke sama by u aja atau bisa ke nomor telkomsel	neutral
kayak salah akun	neutral
kenapa app byu ga bisa buka ga bisa cek sisa kuota dll tcovkbpuvk	negative
gb minggu mana minnnn adain lagi donggg	neutral
aplikasi sama sekali gbs buka gimana si	negative
min cek dm ya dari tadi ko ngga ada sinyal sama sekali ya kartu by u saya	negative
lagi kenapa tolong sinyal h dri kmarin	negative
cape sama kamu	negative
kenapa paket by u unlimited ku gabisa buat netflix game sama apk lain	negative
boro boro g daerah ngepoll g	negative
mau beli paket gabisa bisa	negative
ih benar terus aku sampai pernah lanjut ke aju keluh masalah gitu bene tcojhmwvlqy	negative
min byu lagi lot kah ini jaring saya ilang ilang mulu min	negative
byu ny lg mt kah buka apk ny kok troble trus	negative
saya ga bisa aktivasi perdana by u	negative
siang bisa bantu k kartu yang aku pakai gk bisa konek internetnya	negative
min sinyal by u rumah e terus dari lebaran sampai saat ini kenapa ya	negative
nyanyi lewat playlist lagu di b yu	positive
by u knapaa gabisa buka zoomm not connect mulu w mau uts nii	negative
min apa aplikasi by u sedang ganggu ya saya mau buka aplikasi by u ngga bisa terus	negative
yess sama dan sdh bulan tidak ada baik bnyk yg komplain hal yg sama di play store	negative
min kok kuota kemendikbud saya ga bisa dipake buat whatsapp padahal sinyal g	negative
	
min knp kartu telkomsel biasa ga bisa diconvert by u	negative
sudah tahun bulan hari tidak dapet hadiah lagi tcolsivegoxgx	neutral
min kalo kartu byu ilang bisa di urus ga ya	neutral
di aku aman aja sih tapi pakai paket kuota kalo unlimited baru ngelag	positive
kenapa deh lot banget	negative
lebaran sinyal makin burik	negative
disney tunggu netflix dan hbo ya	neutral
kok tiba paket kemdikbudnya gabisa pakai buat whatsapp piye	negative
sinyal aplikasi cs nya semuanyaaa sama sama bikin puyenggg	negative
aku search di twt banyak yg gabisa kak ak udh hampir minggu gabisa pas pakai tsel bisa	negative
bom kelar masalah dah iyain aja	negative
siang saya beli paket gb nila rb kok blm aktif juga dari smlm	negative
kenapa kalau mau buka aplikasi selalu seperti ini ya mohon bantu tcosymbycdpau	negative
min paket unlimited kalau dipake zoom knp ga bisa	negative
aplikasi kenapa dah salah trs gapernah bisa di buka	negative
woooh pantesan kirain nmr w doang nyata lg trouble yak	negative
min ini kok sinyal sos yaa tolong segera lancar	negative
main bareng klan gua min	negative
tauuu bye aja deh kalau gin trs skiiip mending ganti provider lain	negative
jam malam down terus cepat nya	negative
app went wrong tiap buka kenapa	negative
apn apa euy biar tidak lot	negative
by u kenapa dari kemarin not connected sih	negative
lot banget ga sih	negative
aku emang kayak gitu yu agak lelet telkomsel dkk cara kalo sudah lelet ubah dari g ke h aja	negative
bebas internetan gratis lah	positive
kalo sinyal byu lagi tidak baik baik saja	negative
kurang bagus contoh seperti ini kadang ubah dari g tiba tiba ubah jadi g dan g khus tcosaotoxyeu	negative
min aplikasi byu kenapa gabisa di pakai	negative
maen ml ping nya jumping jumping	negative
mau ngumpulin orang orang yang kecewa pakai ah	negative
kok ga bisa beli pulsa tolong banget ini mah kuota saya tinggal mb	negative
kalo mampir sekali kasih aku kuota gratis dong min	neutral
g nya yg di daerah pinggir	negative
heyy jaring antum masalah hey muhasabah diri antum	negative
ini sudah menit gin terus tcodefodkke	negative
mau buka aplikasi kok ga bisa ya sudah clear cache juga ga bisa	negative
telkomsel lagi ganggu sinyal ya	negative
sudah hari bgini terus knp ya tcobnqodvgspr	negative
main bareng couple seru soal bisa tempat tinggal	negative
boleh tahu by u ada paket unlimited tanpa batas fup	neutral
eh kok tau banget sih akhir bulan gin kuota sekarat terharuuu banget gb juga alhamdulillaah makasih nindyyyyy tcoulgljodnwe	positive
iya benar bgtt saya brp x mati grgr tbtb pingnya ratus	negative
capek juga heyy	negative
aplikasi by u kenapa sih kemarin sudah relain uninstal instal lagi	negative
hai min kalo saya sedang pakai paket data lalu beli paket baru apakah paket yang sedang pakai hangus	neutral
yg bikin aman jaya alias unlimited	positive
tolong dong aku gabisa sama sekali nihhh bahkan pencet registrasi aja gabisa pdahal manual dan udh matiin wifi tadi semper bisa terus kata nomor nik gbs ato apaaagt	negative
luar brand brand sebut ada kah	neutral
kenapa ya topping ggwp ku kok gabisa d pakai pdlhal masih hari beli	negative
sinyal byu yg bagus cuma unlimited doang ya min kalo pakai yg unlimited lancar jaya gilir pakai topping data biasa kadang trouble	negative
saat byu ngasih kuota gratis atau unlimited mbps hari ribu	positive
keren banget dah	positive
ga bisa aktivasi gimana nih tcoumrytrakaq	neutral
sudah hampir minggu kuota internet sy tidak pakai krn jaring telkomsel yg kata sdg maintanance tgl juni paket akhir dengan kuota yg msh sgt banyak tidak ada kah kompensasi dari by u mohon tanggap tcoqnglvxv	negative
makasih buat kado tcoaspbvitq	positive
kak jangan kseringan ubah paket yang kamu tawarin gezz dari yang awal ribu minggu trus skarang jadi tcojbdgfani	negative
aplikasi by u kok ga bisa buka	negative
sayang bet hp nya gk dukung g	neutral
yang make sabar dulu	negative
yahh barusan beli yg unlimited bulan	neutral
min kok no service ya kenapa nih	negative
ku kira cuma aku yang boros banget tcoflzkfbxwt	negative
lumayan buat voucher wish biar dapet ps di aov	positive
min kok nomerku gabisa buat nonton netflix ya thanks	negative
provider abal	negative
nindy kena kakak adek zone sm telkomsel	neutral
byu jugaaakkk setia banget tidak khianat masalah pulsa	positive
sudah dari hari yg lalu loh belum bisa juga buka ni app	negative
appan g ga terlalu harap buat w yg cuma idup di desa	negative
tidak bisa ussd ya please buat reset pin digipos	neutral
aku dpt kuota dari nindy thank you ya tcovxduyohwrg	positive
apa saya pakai jaringanya buat maen aov tidak bisa buat login	negative
baru bulan lancar koneksi eh kambuh lagi rto baris bar mau rumah dibandaradikota dan seluruh surabaya bar signal ga pernah penuh sekali penuh di kota g speed cuman ga sampai mbps ditawarin sales nya ya saya ngomong apa ada koneksi payah	negative
mesti update ganti kartu biar bs g	neutral
lagi ganggu kah	negative
sinyal ngga bagus kayak dulu	negative
drtd zoom kuliah yg sedot kuota pribadi kl provider lain mah apps pilih dari kemendikbud ky zoom gmeet tcowlemrvqe	negative
hari rb gb	neutral
saya sampai ga di absen kuliah ka karna sinyal nya entah kmana	negative
nga mantan bau kambing skrg	negative
g di rumah saya di purwakarta aja masih tidak stabil kadang kalo hujan atau mati lampu sinyal hilang sama sekali	negative
bisa kasih promo ngga	neutral
byu sepi amat	negative
duh min sinyal hari ini h mulu sedih	negative
malam admin apakah jaring byu saat ini sedang ganggu	negative
krtu by u tuh kartu apa sih serius nanya	neutral
minta tolong baik sinyal di daerah mampang prapatan jaksel dong ini sudah jam benar benar blank tidak ada sinyal	negative
parah emg	negative
yg rb gb wuzzzz ga min	neutral
aplikasi lg ngecrash ya huhu mana kl mau isi kuota harus lewat aplikasi baik dong min sistemnyaa	negative
min kenapa jaring internet saya hilang padahal paket masih	negative
samaa ini kenapa min	negative
aman banget min buka apk nya aja something wrongggg buka spotify no internet connection hedeh	negative
yang gb k ko dihilangin min asli sedih banget	neutral
baik banget baru kemaren ngerayain anniv sekarang kasih kado lagi tau aja kalau lagi miskin kuota tcoeqbjxeud	positive
belum masuk di frekuensi band frekuensi uji coba	negative
free diamon mlbb cara claimnya gimana	neutral
by u sudah bisa g	neutral
kenapa apk sering trouble padahal perlu cek pulsa tcowvcffbrp	negative
aplikasi byu lagi error dari tadi ngga bisa buka	negative
jngn bilang nnti by u ngsh kuota grtis ke slruh nctzen buat stream atau n tconbqybfaoot	neutral
aku guna setia by u udh lama ka	positive
loh wkwkwk	neutral
gabisa buka google form mau emosi juga capek bgst tcohockjgt	negative
min aplikasi by u lagi ganggu ya sudah update ga bisa masuk terus ini	negative
hp saya masih g	neutral
makasih akhirnyaa dapet juga tcosmpwfvezx	positive
ga bisa buka aplikasi kenapa ya	negative
aku rada bingung sama semua nya kan harus lewat appnya nih	negative
unlimited rb per bulan karena dipake kerja youtube an netflix an	neutral
min jaring kok tiba tidak stabil	negative
aq pke unlimited yg sbulan min	neutral
moga baik dari kemarin sinyal jelek terus ganggu banget ga bisa fokus internetan	negative
ini kenapa minnn masa ngga ada jaring kok akhir ini suka ngga ada jaring gin si	negative
makasih sudah bantu atas masalah sim card yang hilang	positive
ini kenapa ya kok lot banget dari kemarin cepat downloadnya tidak sampai mbp min	negative
kalau ada kuota gratis sih boleh min	neutral
ketika top by u lewat ovo ngga keburu krn habis waktu saat buka app ovo	negative
jangan deh jangannn produk turun aja masih banyak masalah yakin bisa percaya sama datacenternya saya sudah pakai mungkin hampir semua produk digital turun dan sudah mulai hilang kepercay	negative
tidak usah thr thr an min	negative
min applikasi lagi eror ya	negative
kak min knp jaring internet sini jelek banget ya suka hilang hilang ganggu apa gmn ya	negative
akhir sampai juga dapet sim ejector juga thanks tcourfsmgjnm	positive
beli dulu alat gitu nu berapa itu harga alat nanti jaring darimana nu	neutral
sumpaaahhh iya banget jaring by u skrg ga kaya awal asli ih lot banget saya sampai bolak bal tcodvzorfdnl	negative
karena komplain provider alih profesi jadi dropsiper kraca keong	negative
min sim card saya ilang	neutral
sama ko aku jga ga dapet ya	neutral
halo mimin nindy apaa sedang ganggu yaaa kok apps nya tidak bisa buka tcocaewsms	negative
lagi butuh malah maintenance nih	negative
hari jaring lot banget dah	negative
sudah hari sejak kemarin tidak bisa hubung ke internet padahal sinyal full dan kuota masih banyak	negative
bikin bete yaa lama paling login di hp lain coba kaa siapatau bisa	negative
payah si tidak cuma sinyal yang undlap undlup	negative
apa cuma gua yang selalu begini kalo pakai asa kalo gua liat bang david sinyal always s tcodubjjdbzz	negative
sinyal kekl lont	negative
eh msa sih tiap buln sekali dpt kuota	neutral
yg gb tapi harga k	neutral
dah males	negative
mau nanya min apa benar kartu by u aktif lama lama kartu nya dapet sinyal walau g ada kuota	neutral
huhuhuhu by u kenapaa baikk bgtt sii thank you by u tcobmcrqt	positive
kartu byu aku kok skrg jadi lelet ya jaring nya kenapa dah	negative
lagi di kejar deadline upkoad animasi pakai by u sudah mau kelar dikit lagi jaring ilang bye	negative
iyakannn emang bikin emosiii	negative
dari tadi sore aplikasi nya tidak bisa di buka ngeblank putih gitu benerin min	negative
tolong fokus pada service customers	negative
benar sesuai slogan beli kuota gb d apps pakai metode bayar sudah tcocxubczt	positive
kok nggk bisa login ya tcovhmvtcffv	negative
bisa di fix ini eror bug nya tiba tiba log out sendiri mau login pakai nomor selalu begini	negative
aduh sekarang aja sering h	negative
paling banyak gb	neutral
paraah si	neutral
hai mau tanya kalo kuota saya hangus tapi pulsa masih ada ga akan expired kan maksud saya masih bisa sms amp	neutral
weh ada mimin bayu	neutral
masa di php in terus sama	negative
gua kira cuma app gua aja yg error nyata banyak juga yg error	negative
g aja sering jelek	negative
kenceng sih	positive
tambah ga manusiawi provider ini yang awal nya mudah sekarang bikin susah tcobwoolvre	negative
miminnya gk erti nih kayak	neutral
min km markcity kan ngaku	neutral
goks anjir provider bikin liga fantasi	positive
aku rekomendasiin baik aplikasi dl deh ya min	negative
hubung respon tidak ada	negative
sinyal awal bagus tapi pas on game langsung senin kamis	negative
aku dah pernah nge dm adminnya kak peyeek tetep ae gk ada solusi	negative
wow akhir ada provider internet yang bebasin kamu bikin paket internet semua mau sen sim card nya di sini dan dapetin tambah kuota gb klik di sini tcohkjhvidz	positive
nyata bukan saya doang	negative
benerin dlu jaring nya masa dc mlu ahh	negative
min ko aplikasi tidak bisa buka ya di iphone	negative
etmin pstie slh ekon kan	neutral
beli sim card mana sih	neutral
aku pakai by u kok etmin	positive
kenapa dah aplikasi jadi salah terus gabisa buka	negative
percuma g kalau mase mahal min	negative
kagak bakal padahal jaring busuk banget ya tidak woii	negative
iya aku sudah sejak bulan sih sejak pertama kali pakai by u buka spotify juga ndak bisa	negative
sdh daftar min siap ramai euro fantasy football league by u	neutral
sinyal mohon baik	negative
pagi dah ganggu aja	negative
	
giga rb apa tuh nama paket	neutral
aplikasi parah tcoxrhbhd	negative
min mau kerja udh beli gb kok jaring ilang aku kerja pakai sinyal apa dong	negative
baru aja sy beli kartu perdana di point rest area km b	neutral
min kenapa pakai byu gabisa buka netflix deh website maupun aplikasi gabisa di hp atau di hotspot ke la tcotahravura	negative
byu lagi troubel ya tidak bisa terima sms atau di isi pulsa	negative
wah kalo itu kurang tau juga kak	neutral
wish lu baca sono dm komplain user itu wish orang hadap lu	negative
sinyal dari kemaren lelah	negative
paling parah torrent sih benar kayak kunci speednya dari semua torrent web yg coba sama aja ya mau tidak mau kalo norrent harus ganti provider	negative
aku mau isi kuota nih kenapa appnya keclose mulu ngisi lewat mana jadi	negative
maaf sudah ga betah knapa jaring lu putus	negative
penting bet buat hadap sinyal byu yg lot	negative
eleehh gimana mo streaming jaring hilang lokasi surabaya	negative
sinyal bagus sih aplikasi kagak bisa buka gmn mo beli paket njir	negative
anjing	negative
kalo apa nih nindy	neutral
heheh bagi kado nih tcophcwabtcd	positive
kapan nih kak	neutral
bom masih coba unistall trus install ulang	negative
g ken nambahin pulsa aku ni	neutral
sekarang ada mbps rb	neutral
min astaga sinyal jelek banget	negative
ciee sudah tahun nih kita tcoxaovnfdmk	positive
bisa yg sedot ttp kuota utama	negative
wow by u ngeprank pas malming	negative
maen pubg rto terus terimakasih byu atas lot dan sinyal h nya	negative
aku dapet kado kuota	neutral
sudah by email dari kemaren untung dual sim pakai satu lagi nya masih bisa internetan tcoehcqzjsta	positive
aaaaa yaampun di nerf moonton apa gmn si reconnecting terus lo tcowartlyeyez	negative
min kok app by u gabisa buka	negative
sudah dari jam tcoabdhspgpi	neutral
min ini kenapa gin terus deh padahal udh pakai internetnya by u terus login pakai nomer juga gitu gabisa tcoderwjjxevs	negative
nahh kirain tadi aku doang dari tadi enggak benar benar	negative
tidak bisa lebih lot lagi gan doyan banget dadak turun jd g bahkan no service tcoamdjeizx	negative
pas awal aman aja tapi gilir lagi war zona sudah kecil tiba sinyal ilang itu sih yg paling horor	negative
ihh kece sekaliitt	positive
min kok kuota games tidak bisa buat aov	negative
aplikasi gabisa buka ini knp	negative
ga worth mbps sekarang	negative
aku wa sih twitter masih bisa aneh banget ga siii	negative
min yuk sini mampir kita menggibahin mark	neutral
ya tuhaannn sudah mgg belum masuk juga kuota	negative
eh kamu ga g tah	neutral
bisa dipaksain pakai vpn ehehe v	negative
ini aku ios aja ttp forceclose juga nah	negative
umum menang by u space euro fantasy matchday nya mana min tcowfpsaqxeg	neutral
gabisa dipake nge game ya kasih tcomrjwirsl	negative
kok aku tidak oleh	neutral
pernah internet putus pas presentasi	negative
aktivasi nya susah amat sih	negative
beberapa hari ini gag bisa buka aplikasi ada apa ini sudah di uninstall clear data pdhaal di hp yang lain tcobcerovlwv	negative
btw jangan cuma balas dengan template halo kak	negative
bagaimana kalo isi pulsa pada sim card by u dalam hp	neutral
oh gitu pantesan game ku tak lancar	negative
nyata minta upgrade min	neutral
tarif gimana kk murah kah soal kalau pakai internet kawatir sinyal jelek	positive
tapi apakah nomor by u saya sudah otomatis bisa ke g	neutral
hallo kenapa saya tiba tidak bisa buka netflix ya padahal aplikasi lain lancar mohon bantu thx tcosrdhhrpy	negative
asik tuh buat upload file ke drive cepaaat	positive
min by u kalo pasang di hp yang ngga bisa nyambung internet gmn bisa	negative
anggap saja hadiah ulang tahun dari terimakasih by u tcoymyhjcgd	positive
nungguin reward dari mimin	neutral
sekarang sinyal kenapa bikin nang mulu sih padahal lagi urgent	negative
woi benerin sinyal lah	negative
min kok jauh bngt main	neutral
emosi ya bund sama sinyal di komplain via nindy kata mau di follow up bohong banget	negative
ini bund tidak ada koneksi internetnya tcojpdjjuxe	negative
min aplikasi kok masih error ya mau ngecek kuota gabisa	negative
dapet pesan cinta tcorgndkfjkt	positive
dekat tower elu tong sinyal saya cuma bar neh	negative
ini sinyal kalian dua kenapa heyyy ayo plat merah masa gin	negative
samaa min mau beli pulsa jd ga bs	negative
by u sering banget hilang sinyal padahal sudah sering juga aku protesin	negative
susah banget sinyal nya	negative
sudah nyampe kartu	positive
info promo by u tcovtqxaiorn	positive
podo mosok jaringane e nek ra h	negative
iya nih tidak ada solusi normatif banget jawab	negative
min ini sinyal knp ya sudah jam gabisa tolong dong	negative
banyak km gmw ngasi ak reward gt	neutral
app nya gabisa buka kenapa yah kuota habis lagi	negative
jangan lupa kan tiap bulan juga dapet kuota gratis	positive
tapi dari dulu byu nih suka masalah app nya sudah diupdate rutin masih suka gin kemaren tcofxiytdavx	negative
halo apa port diblock tcodnazzt	neutral
saya rekomendasi untuk baik server min appnya sering eror	negative
fyi kalau jaring udh up ke g semua jaring g daerah pelosok bakal stabil banget kayak sekar tcokiqqrdis	negative
ga bisa nonton euro dong	negative
tidak g tidak masalah	neutral
ini byu knp jaring no connection terus ya padahal baru beli kuota	negative
min fungsi ucoins ini apa ya min btk tcorcajggjqsu	neutral
baru kemaren dapet	neutral
byu knp ngomonginnya mantan mulu daahh ni adminnya gabisa moveon apa gmn	neutral
ko gadapet saya	neutral
tapi lebih senang	positive
aplikasi trouble yaa mau beli kuota kagak bisa	negative
customers servicenya ga excellent nih	negative
dah nih direspon	positive
selamat tinggal byu stlh bln kita sama akhir aku harus kembali lagi ke kartu simpati loop ku yg lam tcovyeftiuwq	negative
dear by u sayang ini kenapa dari tadi aku tidak bisa koneksi h terus ini lagi pakai jaring lain dulu sumpah bikin badmood	negative
ganggu jaring lokasi desa ngringo kec jaten kab karanganyar download upload limit di mbps streaming youtube p aja ga ngangkat buffering kenapa sejak pagi tadi padahal pakai paket gb tcotaekbqmj	negative
sim card byu support g segera luncur min	positive
bayu yg ini baru gapernah salah	positive
ko aku ga dapet pas ultah	neutral
hari ke belakang internetnya lot	negative
min kok aplikasi di hape reconnect terus ya	negative
tolong dong kartu fisik saya rusao gabisa baca solusi gimana	neutral
untuk bisa nikmat jaring g apakah harus ganti simcard	neutral
tidak bisa di pakai sudah beli paket rb	negative
tempat saya ping nya besar mbak nin suka ngelag	negative
minn ini sinyal kenapa ngadett	negative
bukan kamu anak telkomsel	neutral
jaring bagus ping ga merah	negative
haloww min kapan benar aplikasi update mulu error mulu tcojfqvwnki	negative
by u seems so problematic af	negative
toping streaming nya min utama netflix	neutral
ih keren banget aku kasih kuota gratis tau aja kalo wi fi di rumah lagi error thanks p tcofwqddqzvq	positive
cara beli kartu gimana	neutral
gin amat sinyal lu	negative
mimin aja buka cabang gih buruann	neutral
baik banget deh terimakasih tcozhcbgqlwjn	positive
makasih by u buat kuota gratis	positive
by u tanpa koneksi internet by b babi	negative
bisa tidak eror tidak dari tadi buka aplikasi by u tidak bisa loh	negative
kok sinyal hilang yah min daerah mampang prapatan	negative
min jaring masih ganggu kah ini blm g jaring h mulu	negative
makas ya giftnya tcooeqnfbzib	positive
jarang make kartu bayu	negative
ngelag cok kalau main pakai by u	negative
ada masalah apa sih dulu beli kuota malah tidak bisa dipake sekarang bisa dipake malah suka gk bisa load p tcomaeterg	negative
thanks by u sejak pindah ke by u push rank jadi lebih enjoyable sebelumx pakai belah sampai kena pinalty credit score ke krn afk hilang jaring	positive
oh ini akun ga bakal ngerespon yang nanyain koneksi lot ya	negative
jaring tuh urus makin hari tidak stabil	negative
balikin uang saya	negative
jrngnbyu ditmptsaya super lemotkmn saya hrus komplenke atau	negative
min kenapa sinyal jeleee banget akhir ini	negative
ini kenapa sih aplikasi nya susah banget buay buka	negative
cara buat aktifinnya gimana ya min tcoideukay	neutral
tadi sempat hilang ya koneksi padahal sinyal lagi penuh	negative
nindy maen pubg aja nnti jobs nya aku gantiin	neutral
unlimited yg k lot banget kenapa ya kata mbps tapi pas cek tidak sampai are you kidding me tcooqjswwd	neutral
sudah sering min koneksi ngga stabil cape dm mulu	negative
sekarang lot	negative
ini provider baru kak	neutral
topping dota kek sama game lai	neutral
aplikasi error enggak bisa beli paket	negative
walupun simpati as dan loop jadi satu tetap pilih	positive
kalau ada event streaming bisa nyampe gb an lah oh iya min kok by u jelek buat main mlbb padahal beli tcotgaayqt	negative
tolong kenapa aplikasi by u tidak pernah bisa buka pakai jaring sendiri tapi buka pakai operator lain tcoobelqpq	negative
hallo kak gaada niat mau pasang tower di daerah gresik ta masa sinyal cuma h doang kak	negative
kenapa sulit akses ya	negative
cs nya kecewa	negative
ga ada jaring inetnya mungkin by u nya mas alias ngeblank	negative
mau tanya min untuk paket unlimited mbps dan mbps apakah tidak bisa guna untuk layan zoom thx	neutral
coba ubah sinyal ke h dulu buat masuk ke aplikasi bro	negative
g direspon min sinyal by u lokasi rumah saya hilang kalo lokasi lain ada kenapa min	negative
moga jadi provider baik untuk anak muda	positive
gimana mau beli kuota kalau buka app aja gin terus tcofhecpxcox	negative
min mau panjang kuota kan kok gabisa sih padahal kan pakai wifi tcoplmuaqq	negative
min aplikasine by u iki kenek opo wis ping aku uninstall kok kyok ngene ae tampilanne mosok nek kate tu tcoooimdnoxy	negative
kalo buat iklan emang lebih masuk akal pakai bit karena ga semua customer paham beda bit dan byte	negative
keren banget by u beli kartu bisa requestan sendiri nomornyaaa hehe dulu awal beli masih gabisa jadi pakai tahun biasss dehh jae pacar pacar tcogtrcjbcuj	positive
coba lagi karna mas banyak gagal lain	negative
ini aplikasi selalu gin apa aplikasi terlalu berat ya mohon depan baik karena saya suda tcofvwfybheh	negative
minnn ganti akun dlu atuh	neutral
kuota aja min dimurahin buat g rb gb bulan gitu	neutral
mimin kenapa aku tidak pernah bisa play spotify sihhhh semua lancar kecuali spotify	negative
ku kira ini akun cosplay nyata beneran	neutral
aku juga sering kayak gitu kenapa ya min trus nggk bisa pakai zoom juga hari ini nghk bisa bu tcoxzmpvnv	negative
mau beli paket pas bayar muter terus	negative
bro tolong rank gua turun mulu nih gara sinyal lu	negative
min ini gimana kok mau buka aplikasi byu enggak bisa mau cek sisa kuota ampe jam brpa sama beli paket dat tcooywhtqdp	negative
haloo saya user bayu jika internet kuota internet masih ada apakah akan hangus sesuai tanggal yang tentu atau bagaimana	negative
parah banget sinyalnyaaaaaa ampun	negative
anda sisa paket yg tidak habis bisa pakai untuk bulan ikut dengan syarat isi paket apa di bu tcosobssxig	neutral
aku nunggu g	neutral
makasih loh by u	positive
ga dapet thr	negative
balikin gb rb dong	neutral
ken bebas internetan dari byu dong	positive
apakah by u support g atau g karena di daerah depok jawa barat hanya g saja tulis	neutral
sampai skrg juga masih sudah di unins beberapa kali masih tetep	negative
g aja sinyal acak kadut	negative
sinyal h teroosss sudah hari zoom youtube bakh browsing ae lot kek kura	negative
baca dong saya juga kecewa sinyal lo jelek banget	negative
gmn sih cara ke by u space	neutral
iya nih by u force close melulu	negative
gapaham lg sudah x nyoba ttp aja sudah gabisa di pakai kalau abis mb awal si kira ganguan apa gmna eh trnyata nyoba beli lg ttp aja yg bisa di pakai buat game cuma mb tcoswqupgtui	negative
kenapa ya akses ig pakai by u ga bisa load image amp	negative
apakah ada masalah hari ini saya kok log in aplikasi daritadi tidak bisa suruh coba beberapa saat terus tidak bisa paket ini huhu	negative
min apakah ada solusi buat saya yg masalah itu hp saya udh ga support aplikasi by u karena prosesor tcoeooharj	negative
hari gin masih belum pakai by u jamin nyesel deh klian yg gapake by u	positive
sudah beberapa lama ga bisa buka aplikais tokped pakai by u hari ini buka flip ga bisa padahal pakai provider lain bisa di saat yg sama pliss atuhlah saya sudah pakai yg unlimited bisa buka teams masa buka aplikasi ndak bisa	negative
handphone baru alih juga ke tcoymuqjxqaky	positive
tolong sobat aku ini kasih apresiasi karena gigih nyaranin aku pakai by u dari tcofhrmeyou	positive
aman jaya tethering la wong pakai sendiri sudah tir tir speed nya	negative
masih sinyal ngantuk	negative
cma ken bebas main game	neutral
kenapa app b yu susah banget buka ga bisa bisa terus	negative
punya juga gabisa temenku bisa kenapa deh	negative
mau metode bayar kok ga bisa ya loading terus padahal pakai wifi internet lai lancar	negative
min piala eropa dah mau mulai apa gada kuota streamingnya xixixi	neutral
youtube twitter mungkin perlu tambah lg batas kuota topping	neutral
cuma ken sambat aja saking vc mati tiba trs parah dah	negative
by u anak milenial ya tidak	neutral
makasih kado bulanya min	positive
tolong aplikasi gamau buka ih sebel udh tau mau beli kuota	negative
skuy nindy mabar game apa nihh	neutral
halo ini kenapa ya udh jam cuma panggil darurat aja saya udh make mode pesawat udh restart hp masih gabener juga jd ganggu kerja saya tau ga hadeh tcovrfcgyrty	negative
sinyal makin hari makin jelek	negative
puyeng emang k	negative
ini sudah isi pulsa tapi gk bisa masuk aplikasi buat beli kuota apa guna yakk	negative
dah lah bubar aja	negative
kak kok sum card saya tiba mati dan internetnya ga konek ya td awal sinyal malah tiba sos sekarang sih sinyal ada tapi tidak bisa konek internet	negative
buat esim dong min	neutral
ini knp y min tiap kali buka aplikasi pasti error terus ya amp	negative
kalo buat internet gag lot tapi latensi kalo buat main game yg jelek	negative
min saya udh beli kuota internet byu tapi kenapa ga bisa pakai yaaa ga konek trs dari kmren tcooetirkksau	negative
selamat malam halo min kenapa aplikasi by u tidak bisa cek sama beli kuota ya	negative
sinyal di tempat aku juga sering loncat kek pocong anjay	negative
iya sih cuma heran aja kok promonya olah mbps beneran padahal kbps doang mana di gambar bilang asig bisa tethering harus ngiklan yg real kbps biar orang tidak tipu kaya saya	negative
emg gabisa trf pulsa ya	neutral
kenapa lot banget hari ini telkomsel amp	negative
belum pakai by u bisa rb bulan	neutral
masa buka aplikasi aja susah banget ga bisa bisa	negative
gk bisa buat beli di google play ya	neutral
mau tanya ini bayu tidak ada topping untuk sms ya terus kalau kirim sms ke operator lain berapa	neutral
ayo bikin byu tidak usah bulan minggu aja loss speed unlimited	neutral
min ini knp internetnya ga bisa ya	negative
kenapa sekarang lot parah gambar twt ga ke loading video ig ga bisa puter sudah pindah haluan saja cuma awal bagus makin kesini ancur mana uang rb habis buat beli kuota yang ga bisa dipake ngapa in cuma wa sama gugel mau	negative
min sekarang gk ada yang gb	neutral
hari ke belakang internetnya lot daerah rangkasbitung tolong solusi thanks	negative
ihiy sudah seth aja nihh timakaci gift nya tcouutfjfb	positive
padahal buat igan twiteran yutuban lancar lancar aja	negative
gilakkkk keren nih dapat kado dari	positive
admin ini aplikasi byu emg gabisa buka apa gmn mau beli paket kuota gabisaa helpp	negative
kuota gb turun harga	neutral
apa yg bisa di laku ini sudah beli tapi tidak bisa di guna tcoahmzgcl	negative
hallo min akhir ini kenapa byu lot banget ya padahal sinyal penuhh mau searching aja lama benerr	negative
apa signal lu kek eek	negative
trauma nihh dulu pakai yg unli mbps tapi buat download lama buat update apk aja lama	negative
by u kenpa sih tiap buka app lot banget	negative
jaring baru yang lot	negative
bisa promo unlimitied tidak	neutral
begini terus nih gimana sih ga jelas banget tcouroqahohkb	negative
kenyang kuota	positive
cinta banget tcozyvsxzs	positive
ini jaring kenapa ya by u min sejak malam posisi di pulo gadung	negative
hallo saya tidak bisa masuk apps	negative
kek sales aja lu ampe segitunyaa	neutral
ya kali dh tiap hari begini emang dh kalo backup yg merah suka kecewa mending indosat sinyal	negative
jaring byu error buat wa zheyeng	negative
aplikasi kok nda bisa buka	negative
nindy ini kenapa yaa tcovvdqfvjf	negative
wk sabar sabar ini uji	negative
apakah by u support g jiga seperti telkomsel	neutral
admin ngapa ya saya mau beli pulsa gin muluuu tcovnpwhqyl	negative
ini kenapa jadi zoomed semua ya masuk bayar juga jadi ikut zoomed tolong dong baik tcouorgsx	negative
ada yg pernah beli kuota topping youtube gb	neutral
samaaa gadapet juga apa guna lama pada gadapet ya	negative
gk bisa log in make jaring byu gimana ini tcobqzbhykezr	negative
iya aku sudah dari lama begini aku kira error hari aja nyata lama banget viasanya kalo tcovdidecnflh	negative
masih enak jaman g	negative
min kenapa aplikasi ny u gabisa akses terus yak	negative
kak saya lupa kasih catat email pas beli kartu di shoppe	neutral
apk nya knp load mulu ya mau isi kuota ini bntr lagi abis gmnaa	negative
ini sinyal wilayah sukoharjo kenapa hilang ya	negative
halo kak mau tanya kalo misal kartu provider hilang itu bagaimana ya kak	neutral
min internet byu saya kok gbs ya bisa di cek kah	negative
lagu lama byu jaring payah	negative
ko banyak yg ilang sih paket nya	negative
